new unique backpack ! combines vintage with modern ! URL1283 via @USER415	ADJ ADJ NOUN PUNCT VERB NOUN ADP PROPN PUNCT X ADP PROPN
RT @USER767 : It 's been 3 years since the release of the music video of Burning Desire . URL637	X X PUNCT PRON AUX AUX NUM NOUN ADP DET NOUN ADP DET NOUN NOUN ADP PROPN PROPN PUNCT X
#openfollow for kpopers just retweet	VERB ADP PROPN ADV VERB
RT @USER526 : empathy 4 Kesha .... the worst . smh smh .. 💔	X X PUNCT VERB NUM PROPN PUNCT DET ADJ PUNCT INTJ INTJ PUNCT SYM
RT @USER2128 : do n't jump to conclusions . do n't take what the media says at face value . do your own research & stay informed . stop falling …	X X PUNCT AUX PART ADJ ADP PROPN PUNCT AUX PART VERB PRON DET NOUN VERB ADP NOUN NOUN PUNCT VERB PRON ADJ NOUN CCONJ VERB NOUN PUNCT VERB NOUN PUNCT
RT @USER445 : Spine - Chilling Stories of Real Life Cannibals , Horrible ! URL1310 URL1455	X X PUNCT PROPN PUNCT PROPN NOUN ADP ADJ NOUN PROPN PUNCT PROPN PUNCT X SYM
I 've entered for a chance to win a copy of @USER1136 on XB1 from @USER1071 thanks to @USER718 ! Enter HERE : URL1617	PRON AUX VERB ADP DET NOUN PART VERB DET NOUN ADP NOUN ADP NOUN ADP PROPN NOUN ADP PROPN PUNCT VERB ADV PUNCT X
Our military is doing everything it can to equip Iraq 's forces so our troop ... #MikeRogers #quotation URL1226	PRON NOUN AUX VERB PRON PRON AUX ADP ADJ NOUN PART VERB ADV PRON NOUN PUNCT PROPN X X
join our book club and learn about a lot of great books URL1049	VERB PRON VERB NOUN CCONJ VERB ADP DET NOUN ADP ADJ NOUN X
RT @USER2270 : Keep in mind that some things will never make sense , no matter how hard you try to figure it out . Let go , breathe deeply & l …	X X PUNCT VERB ADP NOUN DET DET NOUN AUX ADV VERB NOUN PUNCT PRON VERB ADV ADJ PRON VERB PART VERB PRON ADV PUNCT VERB VERB PUNCT PROPN NOUN CCONJ NOUN PUNCT
RT @USER487 : Where is AKMU Where is MADE full album Where is EXIT : X Where is YGGG Saddest ? Where is Minzy ?	X X PUNCT ADV AUX ADJ ADV AUX VERB ADJ NOUN ADV AUX ADJ PUNCT PROPN ADV AUX ADJ PROPN PUNCT ADV AUX ADJ PUNCT
RT @USER2437 : If you have short memory let me inform you after signing COD Benazir made infamous NRO deal with Mushi . ☺ URL224 …	X X PUNCT SCONJ PRON VERB ADJ NOUN VERB PRON VERB PRON ADP VERB PROPN PROPN VERB ADJ NOUN VERB ADP PROPN PUNCT SYM X PUNCT
RT @USER1218 : @USER265 Blessed Sunday 😊	X X PUNCT PROPN PROPN PROPN SYM
Just because a nigga f*cks you , Does Not mean he loves you !!	ADV SCONJ DET NOUN VERB PRON PUNCT AUX PART VERB PRON VERB PRON PUNCT
Get Weather Updates from theweatherchannel 10:56:06	VERB VERB NOUN ADP PROPN X
" @USER1771 : Denial has become such a comfort for some that the truth has become an illusion . "	PUNCT PROPN PUNCT PROPN AUX VERB DET DET NOUN ADP DET DET DET NOUN AUX VERB DET NOUN PUNCT PUNCT
" You should know , that if you come any closer .. I wo n't let you go . "	PUNCT PRON AUX VERB PUNCT PRON SCONJ PRON VERB DET NOUN PUNCT PRON AUX PART VERB PRON VERB PUNCT PUNCT
#NowPlaying Get Another Boyfriend of @USER1659	PROPN VERB DET NOUN ADP NOUN
#baseball Bengie Molina considers retirement after World Series URL87	PROPN PROPN PROPN PROPN NOUN ADP PROPN PROPN X
#championLife RT @USER2393 : Lakers game wo n't start until they get those rings right ? See you at 10:45	PROPN X X PUNCT PROPN NOUN AUX PART VERB SCONJ PRON VERB PRON NOUN ADV PUNCT VERB PRON ADP PROPN
#howcome condoms smell so bad !!!!!!	PROPN PROPN VERB ADV ADJ PUNCT
#nothappy that Adelaide has lost the #rugbysevens	VERB SCONJ NOUN AUX VERB DET NOUN
. @USER1012 & I are talking about optics entrepreneurship & " the Actuality story " tonight Media Lab E14 - 525 6 p - 8 p for URL51	PUNCT PROPN CCONJ PRON AUX VERB ADP PROPN NOUN CCONJ PUNCT DET ADJ NOUN PUNCT NOUN NOUN PROPN NOUN PUNCT PROPN NUM NOUN PUNCT NUM NOUN ADP PROPN
1 , 2 , 3 , 4 , 5 Teen Titans !	NUM PUNCT NUM PUNCT NUM PUNCT NUM PUNCT NUM PROPN PROPN PUNCT
; idk why ... but ifeel like talkin dirty O_o	PUNCT PROPN ADV PUNCT CCONJ VERB ADP PROPN ADJ NOUN
@ troy smith is about to finish the rest of the season for the 49ers ... he 's gon na get them a win this week	ADP PROPN NOUN AUX ADP PART VERB DET NOUN ADP DET NOUN ADP DET NOUN PUNCT PRON AUX VERB PART VERB PRON DET VERB PRON NOUN
@USER90 NBC is going to have the NYC fireworks on . They are amazing - at least in person they were two years ago .	PROPN PROPN AUX VERB PART VERB DET NOUN NOUN ADP PUNCT PRON AUX ADJ PUNCT ADP ADV ADP NOUN PRON AUX NUM NOUN ADV PUNCT
@USER153 I 'm scoopin Jo right now	PROPN PRON AUX ADJ PROPN ADV ADV
@USER272 I 'm from england . Where 's missiuri ?	PROPN PRON AUX ADP PROPN PUNCT ADV PART ADJ PUNCT
@USER288 i did tooo ! this is getting goood . lol	PROPN PRON VERB VERB PUNCT PRON AUX VERB PROPN PUNCT INTJ
@USER312 well I 'm fuckn amazin .. lol ... tottaly awsome who 's bad now lol	PROPN INTJ PRON AUX ADJ PROPN PUNCT INTJ PUNCT PROPN PROPN PRON AUX ADJ ADV INTJ
@USER349 I already have sis !!! Girl they hate me !	PROPN PRON ADV VERB NOUN PUNCT PROPN PRON VERB PRON PUNCT
@USER355 yea I was wondering if after they banned the indian we got a new one	PROPN INTJ PRON AUX VERB SCONJ SCONJ PRON VERB DET ADJ PRON VERB DET ADJ NOUN
@USER357 :D	PROPN SYM
@USER367 lmbo	PROPN PROPN
@USER403 the one you said you was gon na make . the one i bought everything for and have been waiting for ?	VERB DET NOUN PRON VERB PRON AUX VERB PART VERB PUNCT DET NOUN PRON VERB PRON ADP CCONJ AUX AUX VERB ADP PUNCT
@USER446 how ??!	PROPN ADV NOUN
@USER447 miss yhuuuu !	PROPN VERB PROPN PUNCT
@USER547 that is the most stunning creature I have ever seen	VERB PRON AUX DET ADJ NOUN PROPN PRON VERB ADV VERB
@USER600 Yeah I m goodie just in the lab working ... Wow ! I need to be where you at ! lol let me visit	PROPN INTJ PRON AUX VERB ADV ADP DET NOUN VERB PUNCT INTJ PUNCT PRON VERB PART AUX ADV PRON ADP PUNCT INTJ VERB PRON VERB
@USER678 that 's a tight score .	VERB PRON AUX DET NOUN VERB PUNCT
@USER688 I hear enough talking , just turn round keep walking haha in that part	PROPN PRON VERB ADJ VERB PUNCT ADV VERB NOUN VERB VERB INTJ ADP DET NOUN
@USER771 that 's ladybug	VERB PRON AUX ADJ
@USER842 hi , how are you good ? URL142	PROPN INTJ PUNCT ADV AUX PRON ADJ PUNCT SYM
@USER915 oh nasty perv lol	PROPN INTJ ADJ NOUN INTJ
@USER935 aight leaving my crib in 20 minutes	PROPN PROPN VERB PRON NOUN ADP NUM NOUN
@USER1007 has no sense !!! LOL	PROPN VERB DET NOUN PUNCT INTJ
@USER1022 I had potted shrimp last night . Except someone else ordered it & I could n't work out why we had creme brulee for a starter ...	PROPN PRON VERB ADJ PROPN ADJ NOUN PUNCT VERB PRON ADJ NOUN PRON CCONJ PRON AUX PART VERB ADV ADV PRON VERB ADJ NOUN ADP DET NOUN PUNCT
@USER1031 lol you 're lame ;)	PROPN INTJ PRON AUX ADJ SYM
@USER1039 benadryl is your friend lol	PROPN PROPN AUX PRON NOUN INTJ
@USER1074 @USER2632 @USER1318 @USER1108 can i have your email so i can invite you to a sample sale	PROPN PROPN PROPN PROPN AUX PRON VERB PRON NOUN ADV PRON AUX VERB PRON ADP DET NOUN NOUN
@USER1094 * jumps down walking over to you singing * Why do you do what you do to me ? Yea ! Why wo n't you answer me answer me ! Yea !	PROPN PUNCT VERB ADV VERB ADP ADP PRON VERB PUNCT ADV AUX PRON VERB PRON PRON VERB ADP PRON PUNCT INTJ PUNCT ADV AUX PART PRON VERB PRON VERB PRON PUNCT INTJ PUNCT
@USER1144 right back atcha bro :)	PROPN ADV ADV PROPN NOUN SYM
@USER1163 haha u wish ! Just wait for me to fins a cool name tht has darren + loewe in it lol ( everything sounds bad :( )	PROPN INTJ PRON VERB PUNCT ADV VERB ADP PRON PART VERB DET ADJ NOUN NOUN AUX ADJ SYM NOUN ADP PRON INTJ PUNCT PRON VERB ADJ SYM PUNCT
@USER1255 Not as bent as my finger ! It looks freaky !	PROPN PART SCONJ VERB ADP PRON NOUN PUNCT PRON VERB PROPN PUNCT
@USER1286 @USER2183 nigga u quit to	PROPN ADJ NOUN PRON VERB ADP
@USER1290 give him my love !	PROPN VERB PRON PRON NOUN PUNCT
@USER1369 @USER2166 Woooooooow	PROPN PROPN NOUN
@USER1381 of course she is lol	VERB ADV ADV PRON AUX INTJ
@USER1435 ha ! I 'm gon na go with yes	PROPN X PUNCT PRON AUX VERB PART VERB ADP NUM
@USER1439 I 'M on east coast and their on . do n't know how that works live in CA. ? WITWIAL	PROPN PRON AUX ADP PROPN NOUN CCONJ PRON ADP PUNCT AUX PART VERB ADV PRON VERB VERB ADP PROPN PUNCT X
@USER1480 china	PROPN X
@USER1485 .. hey no shine .. lol jk .. how been bro ?	PROPN PUNCT INTJ DET VERB PUNCT INTJ VERB PUNCT ADV AUX NOUN PUNCT
@USER1493 Key and Jjong are together . >.>	PROPN NOUN CCONJ NOUN AUX ADV PUNCT X
@USER1558 yea ik , just for me hahaa	PROPN INTJ PROPN PUNCT ADV ADP PRON VERB
@USER1602 @USER1512 I uploaded / uploading remaining albums . Muackszx	PROPN PROPN PRON VERB PUNCT PROPN PROPN NOUN PUNCT X
@USER1612 He better !! We buy his stuff ! haha	VERB PRON ADV PUNCT PRON VERB PRON NOUN PUNCT INTJ
@USER1651 with there boycotts and the way they betrayed the country in ww1 they were right in there assessment	VERB ADP PRON NOUN CCONJ DET NOUN PRON VERB DET NOUN ADP PROPN PRON AUX ADJ ADP PRON NOUN
@USER1676 . Have u meet norway yet ?? Lol	PROPN PUNCT VERB PRON VERB PROPN PROPN PUNCT INTJ
@USER1696 hey girl you awake ?????? And I did thanks !	PROPN INTJ NOUN PRON VERB NOUN CCONJ PRON VERB NOUN PUNCT
@USER1733 Thanks for the #FF !	PROPN NOUN ADP DET NOUN PUNCT
@USER1756 nerp ! Wish I could	PROPN PROPN PUNCT VERB PRON AUX
@USER1763 thanks :3	PROPN NOUN NOUN
@USER1773 come bring me lunch !	PROPN VERB VERB PRON PROPN PUNCT
@USER1774 >_> ok	PROPN PROPN SYM
@USER1820 we got ta test guh ! My teacher said she gne strt takin off points if we late on test dayz ....	SCONJ PRON VERB PART ADJ PROPN PUNCT PRON NOUN VERB PRON VERB VERB VERB ADP NOUN SCONJ PRON ADJ ADP PROPN NOUN PUNCT
@USER1969 Go to sleep . lol	PROPN VERB PART NOUN PUNCT INTJ
@USER2055 perhaps	PROPN PROPN
@USER2082 I 'm a big fan of yours and admire your work , follow me ? [ /35	PROPN PRON AUX DET ADJ NOUN ADP PRON CCONJ VERB PRON NOUN PUNCT VERB PRON PUNCT PUNCT SYM
@USER2201 @USER944 they had their fun , we hd ours ! ;) lmaooo	PROPN PROPN PRON VERB PRON NOUN PUNCT PRON VERB PROPN PUNCT SYM INTJ
@USER2243 noo ... Sostar !!!!	PROPN PROPN PUNCT PROPN PUNCT
@USER2257 All my loving I will send to you ♥	VERB DET PRON VERB PRON AUX VERB ADP PRON SYM
@USER2294 thanks .	PROPN NOUN PUNCT
@USER2337 Talking points ? #RobFord has a new idea to bring to City of Toronto politics : saving money instead of wasting it . #voteto	PROPN VERB NOUN PUNCT PROPN AUX DET ADJ NOUN PART VERB ADP PROPN ADP PROPN PROPN PUNCT VERB NOUN ADV ADP VERB PRON PUNCT X
@USER2503 Reportedly Testing All - Dorito Taco Shell URL204	PROPN PROPN PROPN DET PUNCT PROPN PROPN X X
@USER2583 I think I thought a ticket the other day - PayPal says Yes , Eventbrite 's never heard of me . Can you confirm success / fail status ?	PROPN PRON VERB PRON VERB DET NOUN DET ADJ NOUN PUNCT PROPN VERB INTJ PUNCT PROPN AUX ADV VERB ADP PRON PUNCT AUX PRON VERB NOUN PUNCT PROPN PROPN PUNCT
@USER2589 where are you	PROPN ADV AUX PRON
@USER2626 swag	PROPN PROPN
A woman dat wants me fa me .... dat s all I ask for .	DET NOUN PRON VERB PRON ADP PRON PUNCT PRON AUX DET PRON VERB ADP PUNCT
Amateur Radio – Hurricane Katrina interview and audio | Survival Kits URL49	PROPN PROPN PUNCT PROPN PROPN NOUN CCONJ NOUN SYM PROPN X X
Ambitious young Italians are quitting their country in droves , leaving power in the hands of an elderly elite . URL111 #tsunami	PROPN ADJ NOUN AUX VERB PRON NOUN ADP PROPN PUNCT VERB NOUN ADP DET NOUN ADP DET NOUN NOUN PUNCT X SYM
Be ready for anything because anything goes with me . Check out URL79 #match #sex #real	AUX ADJ ADP PRON SCONJ PRON VERB ADP PRON PUNCT VERB ADP PROPN PROPN X X
Bob and Larry are my new best friends at work ! URL197	PROPN CCONJ PROPN AUX PRON ADJ ADJ NOUN ADP NOUN PUNCT X
Check out Cooking How - To : Homemade Frisco Melts on Tales of a midwestern Housewife ! URL15	VERB ADP PROPN ADV PUNCT ADP PUNCT PROPN PROPN NOUN ADP NOUN ADP DET NOUN NOUN PUNCT X
Cut it out joey ... * talkin to myself *	VERB PRON ADP ADJ PUNCT PUNCT VERB ADP PRON PUNCT
Deputy pulls over FL man , naked teen in backseat ... URL201 #fl #florida #oops #dumb #sex #dui #traffic #news #police	PROPN VERB ADP ADJ NOUN PUNCT ADJ NOUN ADP PROPN PUNCT PROPN PROPN PROPN PROPN PROPN PROPN PROPN NOUN X X
Did I burn down the joint ? I DO N'T THINK SO . I was makin ornaments out of fish hooks .	AUX PRON VERB ADP DET NOUN PUNCT PRON AUX ADJ PROPN ADV PUNCT PRON AUX VERB ADJ ADP ADP PROPN PROPN PUNCT
Does it feel like Summer to you ? It does in Myrtle Beach , South Carolina it s 85 degrees	AUX PRON VERB SCONJ NOUN ADP PRON PUNCT PRON VERB ADP PROPN PROPN PUNCT PROPN PROPN PRON AUX ADJ NOUN
Excellent article about Intelligent Management founder Lepore inspired by Jewish philosophy to find business solutions URL48	PROPN NOUN ADP PROPN PROPN NOUN PROPN NOUN ADP PROPN NOUN PART VERB NOUN NOUN X
Excited for rough cut screening of @USER2147 tonight . Then season premier of Friday Night Lights at the Man-sion . Yessirr .	NOUN ADP ADJ VERB NOUN ADP PROPN NOUN PUNCT ADV NOUN NOUN ADP PROPN NOUN NOUN ADP DET NOUN PUNCT PROPN PUNCT
Facing difficulties in serving elder family member get assistance from respite care service and live life peacefully . URL88	VERB NOUN ADP PROPN PROPN NOUN NOUN VERB NOUN ADP PROPN VERB NOUN CCONJ VERB NOUN PROPN PUNCT X
Figurative speech #Englishmajors help me out : " Twenty sails came into the harbor " is an example of _____________ ? What figurative type ?	PROPN NOUN NOUN VERB PRON ADP PUNCT PUNCT PROPN PROPN VERB ADP DET NOUN PUNCT AUX DET NOUN ADP PROPN PUNCT PRON ADJ NOUN PUNCT
Forgiveness can not be given for those who choose to use Comic Sans in a business web application . #ui #fail	PROPN AUX PART AUX ADJ ADP PRON PRON NOUN PART VERB PROPN NOUN ADP DET NOUN NOUN PROPN PUNCT X X
Good Morning	ADJ NOUN
Gothtober #BLANKtober	PROPN NOUN
Great Gizmos Indoor Garden Green Pots ( Green ) £ 13.94 [ SAVE £ 6.05 ] >> URL13 #bargains #deals 10.27.10	ADJ NOUN PROPN PROPN PROPN PROPN PUNCT PROPN PUNCT SYM PROPN PUNCT PROPN SYM PROPN PUNCT PUNCT PROPN PROPN NOUN X
Guess Who " American Woman "	VERB PRON PUNCT ADJ NOUN PUNCT
Guhhh deeeh you !	PROPN VERB PRON PUNCT
HIGHHHHHH @USER1784 :)	PROPN PROPN SYM
Had Fun , Now I 'm Omw To My Gma House For Her Birthday	PROPN PROPN PUNCT ADV PRON AUX ADJ ADP PRON NOUN PROPN ADP PRON NOUN
Happy Guys Finish Last - EmpowHER.com URL156 vía @USER1854	ADJ NOUN PROPN NOUN PUNCT PROPN PROPN X X
Happy Main Event Day ! GL to all who are playing on Day 1A . Action begins at 3 ET .	ADJ ADJ NOUN NOUN PUNCT VERB ADP DET PRON AUX VERB ADP NOUN PROPN PUNCT PROPN NOUN ADP NUM NOUN PUNCT
Have #PR pros noticed this like #HR pros have ? RT @USER885 : Is HR morphing into PR ? Read and comment : URL39	VERB PROPN PROPN VERB PRON ADP PROPN PROPN VERB PUNCT X X PUNCT AUX ADJ ADJ ADP PROPN PUNCT VERB CCONJ NOUN PUNCT X
Having lunch at lp with 2 great & funny people @USER2359 && @USER2214	ADJ NOUN ADP PROPN ADP NUM ADJ CCONJ ADJ NOUN NOUN CCONJ NOUN
How to Find And Cultivate Your Passion	ADV PART VERB CCONJ VERB PRON NOUN
I 'd like to take this over , , what I 'm tryin' to say is you should be mine ..	PRON AUX VERB PART VERB DET ADV PUNCT PUNCT PRON PRON AUX ADJ PART VERB AUX PRON AUX AUX PRON PUNCT
I 'm at Mr. Mikes . URL8	PRON AUX ADP PROPN PROPN PUNCT X
I 'm at Scopa ( 109A Plaza St. , Healdsburg Ave. , Healdsburg ) . URL5	PRON AUX ADP PROPN PUNCT PROPN PROPN PROPN PUNCT PROPN NOUN PUNCT PROPN PUNCT PUNCT X
I ai n't cheat I played the hand I dealt !	PRON AUX PART VERB PRON VERB DET NOUN PRON VERB PUNCT
I am in concurrence ... Lol RT @USER2558 : @USER923 ex then lol	PRON AUX ADP PROPN PUNCT INTJ X X PUNCT PROPN NOUN ADV INTJ
I call my dad and this dude is blasting music . I ca nt understand him and he keeps saying " what ? " . Does n't that mean turn down the music ? =_=	PRON VERB PRON NOUN CCONJ DET NOUN AUX ADJ NOUN PUNCT PRON AUX PART VERB PRON CCONJ PRON VERB VERB PUNCT PRON PUNCT PUNCT PUNCT AUX PART PRON VERB VERB ADP DET NOUN PUNCT X
I do n't mean to stay awake at this hour . But that is what the poorest of all network would do you when you try to download !	PRON AUX PART VERB PART VERB ADJ ADP DET NOUN PUNCT CCONJ PRON AUX PRON DET NOUN ADP DET NOUN AUX VERB PRON ADV PRON VERB ADP PROPN PUNCT
I do n't see how a pumpkin patch can be more sincere than this one	PRON AUX PART VERB ADV DET NOUN NOUN AUX AUX ADJ NOUN ADP DET NOUN
I do n't want any of these people in my house right now , do n't have anything to talk about , going to bed	PRON AUX PART VERB DET ADP DET NOUN ADP PRON NOUN ADV ADV PUNCT AUX PART VERB PRON PART VERB ADP PUNCT VERB ADP NOUN
I forgot just how good Molson Golden truly is ...... Thanks TIm O	PRON VERB ADV ADV ADJ NOUN PROPN ADV AUX ADJ NOUN NOUN X
I hate how I am sometimes , it really sucks and I over think .	PRON VERB ADV PRON AUX ADV PUNCT PRON ADV VERB CCONJ PRON ADV VERB PUNCT
I made $ 300 . That is on top of the $ 550 I 've made earlier on this trip . Not bad if I do say so myself .	PRON VERB SYM NUM PUNCT PRON AUX ADP NOUN ADP DET SYM PROPN PRON AUX VERB ADJ ADP DET NOUN PUNCT PART ADJ SCONJ PRON AUX VERB ADV PRON PUNCT
I posted 11 photos on Facebook in the album " October 26 , 2010 " URL67	PRON VERB NUM NOUN ADP PROPN ADP DET NOUN PUNCT PROPN NUM PUNCT NUM PUNCT SYM
I think I do +_O " you 're sick " RT @USER878 : Lmao u do n even know what that means RT @USER862 : Lol nawe lol RT	PRON VERB PRON AUX VERB PUNCT PRON AUX ADJ PUNCT X X PUNCT INTJ PRON VERB CCONJ ADV VERB PRON PRON VERB X X PUNCT INTJ VERB INTJ X
I think jawn was tryna be smart talk'n bout da baul little do she know I d nt give two shits about none of these Cheyney boy 's .	PRON VERB PROPN AUX PROPN AUX ADJ NOUN ADP DET NOUN ADJ AUX PRON VERB PRON VERB PART VERB NUM NOUN ADP NOUN ADP DET NOUN NOUN PART PUNCT
I wan na do something tonight .	PRON VERB PART VERB PRON NOUN PUNCT
I want Brazilian food	PRON VERB ADJ NOUN
If you can see only one Darfur documentary this year , I recommend The Devil Came on Horseback . URL2	SCONJ PRON AUX VERB ADV NUM NOUN VERB DET NOUN PUNCT PRON VERB DET NOUN VERB ADP PROPN PUNCT X
It 's raining !! 	PRON AUX VERB PUNCT SYM
It s the little things that strengthen my tiny wings .	PRON AUX DET ADJ NOUN PRON VERB PRON ADJ NOUN PUNCT
Know the Professionals , Information and facts on Cosmetic Dentist Procedures and Treatments : Anybody unfamiliar ... URL50	VERB DET NOUN PUNCT VERB CCONJ NOUN ADP PROPN PROPN NOUN CCONJ NOUN PUNCT PRON NOUN PUNCT X
Lol welcome to Twitter @USER2290	INTJ VERB ADP PROPN X
Lorex LW2003 LIVE snap Video Baby Monitor ( White ) : Get The Lowest Prices On NEW Lorex LW2003 LIVE snap Video Bab ... URL41	PROPN PROPN PROPN PROPN NOUN PROPN PROPN PUNCT ADJ PUNCT PUNCT VERB DET NOUN NOUN ADP ADJ NOUN PROPN PROPN PROPN NOUN PROPN PUNCT X
MATCHES YA FACE SO YOU COOL . RT @USER1964 : @USER127 it s growing but it s at this ugly stage :(	PROPN PROPN NOUN ADV PRON VERB PUNCT X X PUNCT INTJ PRON AUX VERB CCONJ PRON VERB ADP DET ADJ NOUN SYM
Me too , me too , me too RT @USER1524 @USER2374 i hope u come i hope u come i hope u come	PRON ADV PUNCT PRON ADV PUNCT PRON ADV X X PROPN PRON VERB PRON VERB PRON VERB PRON VERB PRON VERB PRON VERB
My book trailer - WORST SINGING EVER ! YAY ! : URL147	PRON NOUN NOUN PUNCT NUM PROPN PROPN PUNCT PROPN PUNCT PUNCT X
My friends category is odd again -.-	PRON NOUN NOUN AUX ADJ ADV SYM
New FC Menu Utility 2.0 #apple URL138	ADJ PROPN PROPN NOUN NUM NOUN X
New NC Highway Signs Welcome Motorists To " Most Military Friendly State " : New signs going up on the major highways ... URL37	ADJ PROPN PROPN NOUN PROPN NOUN PART PUNCT ADJ NOUN ADJ PROPN PUNCT PUNCT ADJ NOUN VERB ADP ADP DET ADJ NOUN PUNCT X
Noo it s not cuss you have swag andd you wo nt look dumb ! @USER2646 !!	VERB PRON AUX PART VERB PRON VERB ADJ PROPN PRON AUX PART VERB ADJ PUNCT PROPN PUNCT
Northrop Grumman 3Q profit rises , boosts forecast ( AP ) : AP - Defense contractor Northrop Grumman Corp. say ... URL24	PROPN PROPN PROPN PROPN PROPN PUNCT PROPN PROPN PUNCT PROPN PUNCT PUNCT PROPN PUNCT NOUN PROPN PROPN PROPN PROPN VERB PUNCT X
Not too bad for missing two labs before that !	ADV ADV ADJ ADP PROPN NUM NOUN ADP PRON PUNCT
On eve of UFC debut , James Toney learned of IRS lien , fight purse withheld URL177	ADP NOUN ADP PROPN NOUN PUNCT PROPN PROPN VERB ADP PROPN PROPN PUNCT VERB PROPN X X
Oo yeaa ii hear thunda ! Rainnn kum onnnnnn	PROPN PROPN PRON VERB PROPN PUNCT PROPN NOUN X
Pain is pleasure	PROPN AUX NOUN
People in school thought my shoes were so sick today . alala . Robert wanted to take them :)) and Jack and Craig tried to wear it . fun day .	NOUN ADP NOUN VERB PRON NOUN AUX ADV ADJ NOUN PUNCT PROPN PUNCT PROPN VERB PART VERB PRON NOUN CCONJ PROPN CCONJ PROPN NOUN PART VERB PRON PUNCT ADJ NOUN PUNCT
Phoooonneeeeeeeeee with my wife !	VERB ADP PRON NOUN PUNCT
Pretty simple actually . - The DataContext will tunnel down to controls below it in the tree . - The ListBox ... URL31 #WPF #2010	ADV PROPN ADV PUNCT PUNCT DET NOUN AUX VERB ADV PART VERB ADP PRON ADP DET NOUN PUNCT PUNCT DET NOUN PUNCT PROPN NOUN X
Public and private jobs | Angry Bear : The wife and I used to work retail for the California State Parks . If our pa ... URL18	PROPN CCONJ PROPN NOUN SYM PROPN X PUNCT DET NOUN CCONJ PRON VERB PART VERB ADJ ADP DET PROPN PROPN PROPN PUNCT SCONJ PRON NOUN PUNCT X
Q : So , if I may ask , how would we " meet u ... A : Lol . I have no clue and yes I would , i ... : URL210	PROPN PUNCT ADV PUNCT SCONJ PRON AUX VERB PUNCT ADV AUX PRON PUNCT VERB PRON PUNCT NOUN PUNCT INTJ PUNCT PRON VERB DET NOUN CCONJ INTJ PRON AUX PUNCT PRON PUNCT PUNCT X
RT @USER93 : @USER1691 @USER1809 @USER2600 @USER2628 Chck out I CAN RAP ! URL216 & the TAKEOVER ! URL214 ...	X X PUNCT PROPN PROPN PROPN NOUN VERB ADP PRON AUX PROPN PUNCT VERB CCONJ DET NOUN PUNCT PROPN PUNCT
RT @USER237 : d-town !	X X PUNCT PROPN PUNCT
RT @USER243 : Bruno Mars hates it when cameramen zoom in too close . #CelebsFacts	X X PUNCT PROPN PROPN VERB PRON ADV ADJ NOUN ADP ADV ADJ PUNCT X
RT @USER337 : I just missed the best twitpic opportunity smh .. This nigga was bald all over but had a pony tail of dreads lol <- 	X X PUNCT PRON ADV VERB DET ADJ NOUN PROPN INTJ PUNCT DET NOUN AUX VERB DET ADV CCONJ VERB DET NOUN NOUN ADP PROPN INTJ VERB X
RT @USER410 : Staring at a hot guy and thinking ... We are going to make beautiful babies .	X X PUNCT VERB ADP DET ADJ NOUN CCONJ VERB PUNCT PRON AUX VERB PART VERB ADJ NOUN PUNCT
RT @USER465 : Damn , when u hit your toe on the door you wan na say every cuss word you know	X X PUNCT NOUN PUNCT ADV PRON VERB PRON NOUN ADP DET NOUN PRON VERB PART VERB DET NOUN NOUN PRON VERB
RT @USER521 : " Do what you can , with what you have , where you are . " - Theodore Roosevelt	X X PUNCT PUNCT VERB PRON PRON AUX PUNCT ADP PRON PRON VERB PUNCT ADV PRON VERB PUNCT PUNCT PUNCT PROPN NOUN
RT @USER887 : when in a relationship You need to understand the other person feelings besides yours .	X X PUNCT ADV ADP DET NOUN PRON VERB PART VERB DET ADJ NOUN NOUN VERB PRON PUNCT
RT @USER951 : Just seen one of my favorite people @USER1297 ... I love her I swear . Muah ! ** awwyyy ! Me heart yu 4x more loveeee !	X X PUNCT ADV VERB NOUN ADP PRON ADJ NOUN NOUN PUNCT PRON VERB PRON PRON VERB PUNCT PROPN PUNCT PUNCT PROPN PUNCT PRON VERB PRON VERB ADJ NOUN PUNCT
RT @USER1119 : I wish someone would have told me that it 's okay to cry over nothing and everything for a little while . #HuggiesMom	X X PUNCT PRON VERB PRON AUX VERB VERB PRON SCONJ PRON AUX ADJ PART VERB ADP PRON CCONJ PRON ADP DET ADJ NOUN PUNCT X
RT @USER1135 : Billionaires / CEOs throwing massive $$$ into front Orgs since Citizens United . They plan to BUY America Gov't in 201 ...	X X PUNCT PROPN PUNCT PROPN VERB ADJ NOUN ADP ADJ NOUN ADP PROPN PROPN PUNCT PRON VERB PART VERB PROPN NOUN ADP PROPN PUNCT
RT @USER1191 : I never bought candy bars from those kids on my doorstep so I guess they ’re all in gangs now .	X X PUNCT PRON ADV VERB ADJ NOUN ADP PRON NOUN ADP PRON NOUN ADV PRON VERB PRON AUX DET ADP PROPN ADV PUNCT
RT @USER1226 : @USER1642 lol you know i m down like 4 flats on a cadillac ... lol wut it do ?? || Haha ! love it	X X PUNCT PROPN INTJ PRON VERB PRON AUX ADV ADP NUM NOUN ADP DET NOUN PUNCT INTJ VERB PRON VERB PUNCT PROPN INTJ PUNCT VERB PRON
RT @USER1233 : Eat that pussc like cold pizza lol	X X PUNCT VERB PRON NOUN ADP NOUN NOUN INTJ
RT @USER1388 : I rather watch water boil ......	X X PUNCT PRON VERB VERB PROPN NOUN X
RT @USER1438 : #Quote of the day : " Fear is just as contagious as courage . Your choice . "	X X PUNCT VERB ADP DET NOUN PUNCT PUNCT PROPN AUX ADV ADP NOUN ADP NOUN PUNCT PRON NOUN PUNCT PUNCT
RT @USER1497 : You aint sh*t .	X X PUNCT PRON AUX ADJ PUNCT
RT @USER1583 : you do nt know shit , about shit	X X PUNCT PRON AUX PART VERB NOUN PUNCT ADP NOUN
RT @USER1594 : #nsnweekend how can people choose there favourite performance , the whole thing was perfect !	X X PUNCT PROPN ADV AUX NOUN NOUN PRON VERB NOUN PUNCT DET ADJ NOUN AUX ADJ PUNCT
RT @USER1818 : Home Opener is 2 days away . Need a costume ? 1st 5000 fans get a Halloween black & orange @USER146 yth jersey URL0 ...	X X PUNCT NOUN NOUN AUX ADJ NOUN ADV PUNCT VERB DET NOUN PUNCT ADJ NOUN NOUN VERB DET NOUN ADJ CCONJ VERB NOUN PROPN X X PUNCT
RT @USER1826 : Tonight I 'm at Club West in San Antonio ... This is what it was like the last time I was there . ( cont ) URL182	X X PUNCT INTJ PRON AUX ADP PROPN NOUN ADP PROPN PROPN PUNCT PRON AUX PRON PRON AUX ADP DET ADJ NOUN PRON AUX ADV PUNCT PUNCT NOUN PUNCT X
RT @USER1992 : When life gives you a hundred reasons to cry , stay strong ! Show life that you have a thousand reasons to smile . - Unknown	X X PUNCT ADV NOUN VERB PRON DET ADJ NOUN PART VERB PUNCT VERB ADJ PUNCT VERB NOUN SCONJ PRON VERB DET NOUN NOUN PART VERB PUNCT PUNCT ADJ
RT @USER2314 : Seeing warped tour ads everywhere makes me want to cry . My favorite bands are having signings and it s killing me alfhak	X X PUNCT PROPN ADJ NOUN PROPN NOUN VERB PRON VERB PART VERB PUNCT PRON ADJ NOUN AUX VERB ADJ CCONJ PRON AUX VERB PRON VERB
RT @USER2484 : " Daddy , what are THESE ? Can I have one ? These . Are . AWESOME !! " Louis , 9 , finding a VHS .	X X PUNCT PUNCT NOUN PUNCT PRON AUX PRON PUNCT AUX PRON VERB NUM PUNCT NOUN PUNCT AUX PUNCT PROPN PUNCT PUNCT PROPN PUNCT NUM PUNCT VERB DET NOUN PUNCT
Say Anything with boyfriend . :))	VERB VERB ADP NOUN PUNCT X
Security Clearance | Systems Admin - Integrated Exploitation Capability ( IEC ) - Lentech , Inc. - St .... URL25 #missouri #jobs	NOUN PROPN SYM PROPN PROPN PUNCT PROPN PROPN PROPN PUNCT PROPN PUNCT PUNCT PROPN PUNCT PROPN PUNCT PROPN PUNCT PROPN X X
Self control app again . Geniusness .	NOUN ADJ NOUN ADV PUNCT PROPN PUNCT
So I told @USER1847 I was gon na tweet from my gate , this is my tweet , there 's some cute guys in hereee . Hollaaaaa	ADV PRON VERB VERB PRON AUX VERB PART VERB ADP PRON NOUN PUNCT PRON AUX PRON NOUN PUNCT PRON AUX DET ADJ NOUN ADP PROPN PUNCT X
So supernatural . Actual and factual . Unstoppable , I 'm possibly the illest possibility .	ADV PROPN PUNCT PROPN CCONJ NOUN PUNCT PROPN PUNCT PRON AUX VERB DET NOUN NOUN PUNCT
TCA to play for Colorado 3A women 's soccer championship . #charterschool #tca #soccer	NOUN PART VERB ADP PROPN PROPN NOUN PART ADJ NOUN PUNCT PROPN X X
THE HEAT WO N'T BE READY ITIL JANUARY BUT WE WILL	DET NOUN PROPN PROPN AUX ADJ NOUN NOUN CCONJ PRON VERB
TRUE BLOOD tonight ... still not sure I am gon na like the new XANADU style storyline they are getting into ... URL47	ADJ NOUN NOUN PUNCT ADV PART ADJ PRON AUX VERB PART ADP DET ADJ NOUN NOUN VERB PRON AUX VERB ADP PUNCT X
The 50 % Return Method Billionaire Investor Warren Buffet Wishes He Could Use , You Can Use ! URL159	DET NUM SYM PROPN NOUN NOUN PROPN PROPN PROPN VERB PRON AUX VERB PUNCT PRON AUX VERB PUNCT SYM
Traffic Generation Strategy : How to Make Any Contest a Slam - Dunk : URL10	NOUN NOUN NOUN PUNCT ADV PART VERB DET NOUN DET NOUN PUNCT PROPN PUNCT X
Twitter off#	PROPN X
Ugh i need a new phone >:I ay !	PROPN PRON VERB DET ADJ NOUN PROPN NOUN PUNCT
Umm @USER1404 took away my favorites and my Dm 's from Aaron ! Lol Naw this is serious ! and slackness .	PROPN PROPN VERB ADP PRON NOUN CCONJ PRON NOUN PART ADP PROPN PUNCT INTJ VERB PRON AUX ADJ PUNCT CCONJ NOUN PUNCT
Upcoming rap artist ? OMFG !! I do n't think so URL9 ! Chuck Norris Starbucks iPod	PROPN ADJ NOUN PUNCT PROPN PUNCT PRON AUX PART VERB ADV VERB PUNCT PROPN PROPN NOUN X
Washing my motorcycle	VERB PRON NOUN
Welcome to our twitter page ! Here we will update you with our weekly specials and monthly giveaways !	VERB ADP PRON PROPN NOUN PUNCT ADV PRON AUX VERB PRON ADP PRON NOUN NOUN CCONJ ADJ NOUN PUNCT
What should be the length of your #maternity #wear ? -part I URL52	PRON AUX AUX DET NOUN ADP PRON NOUN NOUN PUNCT VERB PRON VERB
Whooaaaa bro these CELTICS are god dammmm babies !!! MAN UP	PROPN NOUN DET PROPN AUX NOUN ADJ NOUN PUNCT NOUN ADP
Wo nt let that ruin my night tho ... i m not #goingtobedangry	NOUN PART VERB PRON VERB PRON NOUN ADV PUNCT PRON AUX PART ADJ
Word I 'm bout to holla at her via twitter RT @USER1971 : #trushit - i m tryna fucc nicki minaj lol	PROPN PRON AUX ADJ PART VERB ADP PRON ADP PROPN X X PUNCT PROPN PUNCT PRON AUX VERB PROPN PROPN NOUN INTJ
Wow deep lyrics " when you smile I smile "	INTJ ADJ PROPN PUNCT ADV PRON VERB PRON VERB PUNCT
Wow stuck my hand in his cage and he ran and hid in his tubes /:	INTJ VERB PRON NOUN ADP PRON NOUN CCONJ PRON VERB CCONJ VERB ADP PRON NOUN X
answer : spouting , @USER2570 8/388 points , meaning : URL71	NOUN PUNCT PROPN PUNCT PROPN PROPN NOUN PUNCT PROPN PUNCT X
enjoys a good Snog at lunchtime .	VERB DET ADJ NOUN ADP PROPN PUNCT
going through my flickr .. just thought i d re-share my fave pic of @USER2542 from toronto warped . URL68 <3	VERB ADP PRON NOUN PUNCT ADV VERB PRON VERB VERB PRON ADJ NOUN ADP NOUN ADP PROPN PROPN PUNCT X SYM
it s sad that i m just now watching the Britney #Glee episode , smh	PRON AUX ADJ SCONJ PRON AUX ADV ADV VERB DET PROPN PROPN NOUN PUNCT INTJ
jk one more . URL199	VERB NUM ADV PUNCT SYM
just did some unfollows .. I hate havin #deadweight on my TL	ADV VERB DET NOUN PUNCT PRON VERB ADJ NOUN ADP PRON NOUN
kid cudi is a faggot , that is all	NOUN NOUN AUX DET NOUN PUNCT PRON AUX DET
kinda like that . making a diff in someone s life .	ADV SCONJ PRON PUNCT VERB DET NOUN ADP PRON ADJ NOUN PUNCT
o_o lol RT @USER609 I Herd You Was Good With Themm Softt Lips	PROPN INTJ X X PRON VERB PRON VERB ADJ ADP NOUN PROPN X
rape - the unlawful compelling of a woman through physical force or duress to have sexual intercourse .	PROPN PUNCT DET NOUN NOUN ADP DET NOUN ADP ADJ NOUN CCONJ NOUN PART VERB PROPN NOUN PUNCT
reading harry potter in bed ! waiting for the new south park to come on	VERB PROPN NOUN ADP NOUN PUNCT VERB ADP DET ADJ NOUN NOUN PART VERB ADP
wearing my high school track hoodie ... #memories	VERB PRON ADJ NOUN PROPN NOUN PUNCT X
when is butt pride ? cause i got a big ol trunk wit junk it it	ADV AUX ADJ NOUN PUNCT SCONJ PRON VERB DET ADJ NOUN VERB SCONJ VERB PRON PRON
women music and pineapple @USER738 What are three things you guys just ca nt live without ? #tellme	NOUN NOUN CCONJ NOUN VERB PRON AUX ADJ NOUN PRON NOUN ADV AUX PART VERB ADP PUNCT SYM
would n't that be fucked up if they added a year to Lil Wayne 's jail sentence ? lol	AUX PART PRON AUX VERB ADP SCONJ PRON VERB DET NOUN ADP PROPN PROPN PART NOUN PROPN PUNCT INTJ
@USER1145 Awwww kitty loves you <3	PROPN PROPN PROPN VERB PRON SYM
RT @USER1959 : This face will be all over your computer screen tomorrow night at 8 PM ET ! 😍 URL933 #iHeartZayn URL218 …	X X PUNCT DET NOUN AUX AUX DET ADP PRON NOUN NOUN NOUN NOUN ADP NUM NOUN PROPN PUNCT SYM X X X PUNCT
This being human is a guest house . Every morning a new arrival .	PRON AUX NOUN AUX DET NOUN NOUN PUNCT DET NOUN DET ADJ NOUN PUNCT
RT @USER186 : Gavin McInnes –- Tattoo Advice from a Comedian URL787 URL1464	X X PUNCT PROPN PROPN PROPN VERB NOUN ADP DET NOUN NOUN X
Kiss Daniel – New Era ( Album Tracklist ) : The highly anticipated Kiss Daniel debut album , NEW ERA ... URL955 #Letsdanzit	PROPN PROPN PUNCT ADJ NOUN PUNCT NOUN X PUNCT PUNCT DET ADV NOUN VERB VERB NOUN NOUN PUNCT ADJ NOUN PUNCT X X
Hi Kerry , please register at URL833 if you would like our support . URL591	INTJ PROPN PUNCT INTJ VERB ADP PROPN SCONJ PRON AUX VERB PRON NOUN PUNCT X
Wednesday Special : Roast Beef with Mash Potatoes and vegetables ....... € 9.95 .	PROPN PROPN PUNCT PROPN NOUN ADP PROPN PROPN CCONJ NOUN PUNCT PROPN NOUN PUNCT
When your conductor accidentally throws his baton in the middle of rehearsal 😳😅	ADV PRON NOUN ADV VERB PRON NOUN ADP DET NOUN ADP NOUN X
@USER2487 if I join silver , this will match my name	VERB SCONJ PRON VERB PROPN PUNCT PRON AUX VERB PRON NOUN
RT @USER1296 : #Hope Is Necessary When Living with #Migraine – A Video URL385 @USER239 URL1335	X X PUNCT PROPN AUX VERB ADV ADJ ADP PROPN PUNCT DET NOUN PROPN NOUN X
@USER1488 How can my parcel go missing at your depot ? Had to fork out for another replacement #unimpressed	PROPN ADV AUX PRON NOUN VERB ADJ ADP PRON NOUN PUNCT VERB PART VERB ADP ADP DET NOUN X
RT @USER226 : . @USER798 and her grave can be visited at St Peter 's Church in Bournemouth #MaryShelley URL1008	X X PUNCT PUNCT VERB CCONJ PRON NOUN AUX AUX ADJ ADP PROPN PROPN PART NOUN ADP PROPN PROPN X
RT @USER475 : A day without laughter is a day wasted .	X X PUNCT DET NOUN ADP NOUN AUX DET NOUN NOUN PUNCT
#Deals #7994 3pcs 7.4 V 2000 mAh Battery + Charger For Syma X8W X8C X8G RC Quadcopter Banana P … URL248 URL658	PROPN PROPN PROPN PROPN X PROPN NOUN NOUN SYM NOUN ADP PROPN PROPN PROPN PROPN PROPN PROPN X X PUNCT X NOUN
Killer #eCommerce Starts With Your #CRM URL462 URL977	NOUN NOUN NOUN ADP PRON NOUN X X
@USER872 like afternoon or early mornin ?	VERB ADP NOUN CCONJ ADJ NOUN PUNCT
RT @USER2611 : #booktrailer , #paranormal , #fantasy URL128 Buy link : URL114 URL171	X X PUNCT PROPN PUNCT PROPN PUNCT PROPN PROPN VERB NOUN PUNCT X NOUN
RT @USER1345 : When the BBoyz bust out ampme at the school cafe 😂 URL1034	X X PUNCT ADV DET NOUN NOUN ADP VERB ADP DET NOUN PROPN SYM X
RT @USER2090 : This is Scalia speaking at a commencement in 2010 ... URL768	X X PUNCT PRON AUX ADJ VERB ADP DET NOUN ADP NUM PUNCT X
RT @USER827 : 10 Internet Jokes that Resulted in Jail URL874 … > URL1333	X X PUNCT NUM NOUN VERB PRON NOUN ADP PROPN X PUNCT PUNCT X
I am truly blessed . 😇 URL1253	PRON AUX ADV VERB PUNCT PROPN NOUN
RT @USER120 : Are you ready for an adventure ? URL1026	X X PUNCT AUX PRON ADJ ADP DET NOUN PUNCT X
@USER141 My favourite phrase for them .	VERB PRON NOUN NOUN ADP PRON PUNCT
14221 started on 08/05/2016 Reached its destination CPA and was 10 Mins Before URL945	PROPN VERB ADP PROPN PROPN PRON NOUN NOUN CCONJ AUX NUM NOUN ADP NOUN
visited Ky ❤️ they added so many babies it s cray	PROPN PROPN SYM PRON VERB ADV ADJ NOUN PRON AUX ADJ
Those couples and girls are online now . Visit them now : URL1342 #cam #ebony #webcam #webcammodel URL507	PROPN NOUN CCONJ NOUN AUX ADJ ADV PUNCT VERB PRON ADV PUNCT PROPN PROPN PROPN PROPN X X
RT @USER281 : Discover Various Facts about Reptiles From KidRhymes - URL535	X X PUNCT PROPN NOUN NOUN ADP NOUN ADP PROPN PUNCT PROPN
An invigorating flourish of creativity originates from the rec ... More for Pisces URL244	DET NOUN NOUN ADP PROPN NOUN ADP DET NOUN PUNCT ADJ ADP PROPN X
RT @USER234 : Fancy a Trip Around Taylor Swift 's House ? URL1081 URL311	X X PUNCT VERB DET NOUN ADP PROPN PROPN PART PROPN PUNCT PROPN X
RT @USER1576 : I miss having someone 's company	X X PUNCT PRON VERB VERB PRON AUX NOUN
RT @USER151 : Mean Girls URL582	X X PUNCT PROPN NOUN NOUN
I 'm honestly too sad to sleep now	PRON AUX ADV ADV ADJ PART NOUN ADV
RT @USER1257 : Parents be like : you got mail URL463	X X PUNCT PROPN AUX VERB PUNCT PRON VERB NOUN SYM
RT @USER1266 : #BOHO JEWELRY #Bohemian #Jewelry Stretch #Bracelet #etsy #handmade by JabberDuck URL770 URL225 …	X X PUNCT PROPN PROPN PROPN PROPN PROPN NOUN X VERB ADP PROPN X X PUNCT
RT @USER1499 : 😍😍 " Two piece double lined bikini " Use Discount Code " YUNG " For 15 % OFF ‼️ on SALE now at URL964 URL219 …	X X PUNCT PROPN PUNCT NUM NOUN X PROPN NOUN PUNCT VERB ADJ NOUN PUNCT PROPN PUNCT ADP NUM SYM PROPN NOUN ADP PROPN ADV ADP PROPN X PUNCT
RT @USER408 : Scientist : we 've finally taught a dog Morse Code Dog : [ taps paw ] Me : what did it say ? Scientist : " woof "	X X PUNCT PROPN PUNCT PRON AUX ADV VERB DET NOUN PROPN X X PUNCT PUNCT PROPN NOUN PUNCT PRON PUNCT PRON VERB PRON VERB PUNCT PROPN PUNCT PUNCT PROPN PUNCT
RT @USER643 : Nadine and Kyla !!! 😍 © #JaDineInLoveSingapore URL795	X X PUNCT PROPN CCONJ NOUN PUNCT SYM PROPN NOUN X
@USER1156 Stunningly Beautiful as Always	PROPN PROPN ADJ ADP ADV
it 's game day ... go stangs !	PRON AUX NOUN NOUN PUNCT VERB PROPN PUNCT
RT @USER1926 : Who was removed aftr #GHQ . #MehranBase , #KamraBae , #ParadeLane attacks ? Y #BKU vice - chancellor ? #Marwat Saeb is a prof nt Ge …	X X PUNCT PRON AUX ADJ ADJ NOUN PUNCT PROPN PUNCT PROPN PUNCT ADJ NOUN PUNCT DET ADJ NOUN PUNCT PROPN PUNCT PROPN NOUN AUX DET NOUN PART NOUN PUNCT
♬ Mass Effect ( Original Mix ) - Audiocells	PROPN PROPN PROPN PUNCT PROPN NOUN PUNCT PUNCT PROPN
" I pay you back in car rides and shit " bitch I have my own car .	PUNCT PRON VERB PRON ADV ADP PROPN NOUN CCONJ NOUN PUNCT NOUN PRON VERB PRON ADJ NOUN PUNCT
I posted a new photo to Facebook URL266	PRON VERB DET ADJ NOUN ADP PROPN X
{ GHYR rewind } New Release Round - Up February 29th - March 6th Hey Girl ! Check out these new re URL1005 #BlackAuthors #BlackLit	PROPN PROPN PROPN PROPN ADJ PROPN VERB PUNCT ADP PROPN PROPN PUNCT PROPN PROPN INTJ NOUN PUNCT VERB ADP DET ADJ NOUN PROPN X X
✿ I voted for @USER2116 #NNGlamourGuruKaycee in #Blogopolis4D for best #BeautyBlog ! URL1094	PROPN PRON VERB ADP PROPN NOUN ADP NOUN ADP ADJ NOUN PUNCT X
#PrayForHayes @USER972 Everything will be okay , i 'm sure 💕	PROPN PROPN PRON AUX AUX ADJ PUNCT PRON AUX ADJ SYM
@USER1935 as a Muslim do you also support pedophillia and violent extremism ? Scrolled thru ur tweets , did n't see you speak against that	VERB ADP DET NOUN VERB PRON ADV VERB NOUN CCONJ ADJ NOUN PUNCT PROPN VERB PRON NOUN PUNCT AUX PART VERB PRON VERB ADP PRON
7 PM EST / 1 AM CEST - #GLITCH Label takeover - #hackplaybx #beatmeetandgreet #AndrewFreedmanHome - TONIGHT - URL356	NUM NOUN NOUN PUNCT NUM PROPN PROPN PUNCT PROPN PROPN NOUN PUNCT PROPN PROPN PROPN PUNCT PROPN PUNCT PROPN
I just want a woman who different from women in this generation ...	PRON ADV VERB DET NOUN PRON ADJ ADP NOUN ADP DET NOUN PUNCT
Article spinner software is the best fit with SEO ! URL475	NOUN PROPN NOUN AUX DET ADJ NOUN ADP PROPN PUNCT X
RT @USER2568 : the red stan . constantly talks about the album and her long straight hair . bitter red did n't win a grammy . probably has a nic …	X X PUNCT DET ADJ NOUN PUNCT ADV NOUN ADP DET NOUN CCONJ PRON ADJ ADJ NOUN PUNCT PROPN ADJ AUX PART VERB DET NOUN PUNCT ADV AUX DET NOUN PUNCT
RT @USER1814 : Discover how scrubbing dots make the difference w/ the Scrubbing Dish Cloth ! #ScrubCloth #sweepstakes URL961 …	X X PUNCT VERB ADV ADJ PROPN VERB DET NOUN ADP DET NOUN PROPN PROPN PUNCT PROPN PROPN NOUN PUNCT
RT @USER1272 : A lot of R3 orphans and widows are afflicted by Stockholm Syndrome and are craving for attention of PTs in Twitter	X X PUNCT DET NOUN ADP PROPN NOUN CCONJ NOUN AUX VERB ADP PROPN NOUN CCONJ AUX NOUN ADP NOUN ADP NOUN ADP PROPN
@USER89 @USER974 @USER2387 @USER412 @USER2445 haha she s #bd fan not asmii hater nd hibha lover 😂	PROPN PROPN PROPN PROPN PROPN INTJ PRON AUX ADJ NOUN PART VERB PROPN PROPN PROPN NOUN SYM
RT @USER1354 : If keyboards came with braille on them , we all could have subconsciously learned braille by now .	X X PUNCT SCONJ PROPN VERB ADP NOUN ADP PRON PUNCT PRON DET AUX VERB NOUN VERB VERB ADP ADV PUNCT
RT @USER1893 : Born under a bad sign , you saved my life That night on the roof of your hotel	X X PUNCT VERB VERB DET ADJ NOUN PUNCT PRON VERB PRON NOUN PRON NOUN ADP DET NOUN ADP PRON NOUN
RT @USER1247 : T 2315 - Amazing moment : Raj Kapoor , Shammi Kapoor , Shashi Kapoor with their Mother .. URL755	X X PUNCT VERB NOUN PUNCT PROPN NOUN PUNCT PROPN NOUN PUNCT PROPN NOUN PUNCT PROPN NOUN ADP PRON NOUN PUNCT X
RT @USER1053 : A fantastical mix of mythology and derring - do : URL894 available now on all good #ebook formats . #asmsg …	X X PUNCT DET NOUN NOUN ADP PROPN CCONJ NOUN PUNCT VERB PUNCT PROPN NOUN ADV ADP DET ADJ NOUN NOUN PUNCT X PUNCT
RT @USER2048 : I 'm pretty sure he 'll do a follow spree today . #mondaymotivation	X X PUNCT PRON AUX ADV ADJ PRON AUX VERB DET NOUN NOUN NOUN PUNCT X
Where has my social media presence gone ? Why are n't you all liking my stuff ?	ADV VERB PRON ADJ NOUN NOUN VERB PUNCT ADV AUX PART PRON DET VERB PRON NOUN PUNCT
Want to stay current on an event or trend ? Let @USER1141 discover and share the content for you . URL1625	VERB PART VERB NOUN ADP DET NOUN CCONJ NOUN PUNCT VERB PROPN NOUN CCONJ VERB DET NOUN ADP PRON PUNCT X
Nine killed , eight missing in landslide in Arunachal Pradesh URL926 #TopNews #India	PROPN VERB PUNCT NUM NOUN ADP NOUN ADP PROPN PROPN PROPN X X
RT @USER580 : me on my first date URL1032	X X PUNCT PRON ADP PRON ADJ NOUN SYM
RT @USER2289 : * retweets * * un-retweets * * quotes and says LMAOOOOOOO * * retweets *	X X PUNCT PUNCT PROPN PUNCT PUNCT PROPN PUNCT PUNCT NOUN CCONJ VERB NOUN PUNCT PUNCT PROPN PUNCT
RT @USER1760 : You only need two close friends in which you can trust and dedicate yourself to . Having too many friends can lead to de …	X X PUNCT PRON ADV VERB NUM ADJ NOUN ADP SCONJ PRON AUX VERB CCONJ VERB PRON PART PUNCT PROPN ADV ADJ NOUN AUX VERB ADP PROPN PUNCT
RT @USER2085 : Do n't mix ur words wid ur Mood coz u have many options to change ur mood but u never get any option to replace ur spoken w …	X X PUNCT AUX PART VERB PRON NOUN VERB PRON VERB VERB PRON VERB ADJ NOUN PART VERB PRON NOUN CCONJ PRON ADV VERB DET NOUN PART VERB PRON VERB ADP PUNCT
@USER2299 Nikki no , you ’re better than that	PROPN VERB INTJ PUNCT PRON AUX ADJ ADP PRON
RT @USER561 : Trump " does n’t care who gets hurt as long as he makes a profit off it . That can not be the person who leads the United S …	X X PUNCT PROPN PUNCT AUX PART VERB PRON VERB ADJ SCONJ ADJ SCONJ PRON VERB DET NOUN ADP PRON PUNCT PRON AUX PART AUX DET NOUN PRON VERB DET PROPN PROPN PUNCT
RT @USER206 : I have a good heart ... but this attitude	X X PUNCT PRON VERB DET ADJ NOUN PUNCT CCONJ PRON NOUN
" How are you " " Fucking awful or did you want me to lie and say good how are you ? " URL569	PUNCT ADV AUX PRON PUNCT PUNCT VERB ADJ CCONJ VERB PRON VERB PRON PART VERB CCONJ VERB ADJ ADV AUX PRON PUNCT PUNCT SYM
@USER2335 You ’re on the list ! We ’re on our way with Red Bull to help you through your workday .	VERB PRON AUX ADP DET NOUN PUNCT PRON AUX ADP PRON NOUN ADP PROPN NOUN PART VERB PRON ADP PRON NOUN PUNCT
@USER533 @USER949 some females do n't care as long as they get all the attention . That ai n't me tho	PROPN VERB DET NOUN AUX PART VERB SCONJ ADJ SCONJ PRON VERB DET DET NOUN PUNCT PRON AUX PART PRON ADV
@USER1706 cmon now . That 's bro	PROPN PROPN ADV PUNCT PRON AUX NOUN
RT @USER1453 : Was all of this legal ? URL1244	X X PUNCT VERB DET ADP DET NOUN PUNCT X
RT @USER201 : 14th Feb 2015 : World Cup first match 14th Feb 2016 : Ind vs SL T20 Cricket lovers have a reason to Celebrate Valentine …	X X PUNCT PROPN NOUN NUM PUNCT PROPN PROPN ADJ NOUN PROPN PROPN NUM PUNCT VERB ADP PROPN PROPN PROPN NOUN VERB DET NOUN ADP PROPN PROPN PUNCT
RT @USER1468 : Season ticket renewed . Thanks to all that walked out last season to keep the prices down . @USER1245 @USER2473 👊🏻	X X PUNCT NOUN NOUN VERB PUNCT NOUN ADP DET PRON NOUN ADV ADJ NOUN PART VERB DET NOUN ADV PUNCT PROPN NOUN NOUN
RT @USER2360 : 2ne1 will forever be my favorite girl group 💕 #7YearsWith2NE1 URL1202	X X PUNCT PROPN AUX ADV AUX PRON ADJ NOUN NOUN SYM NOUN X
RT @USER2644 : @USER493 Do you miss those days ? URL522	X X PUNCT PROPN AUX PRON VERB PRON NOUN PUNCT SYM
RT @USER1052 : To all those it does n't matter to because they 'll be dead soon anyway - how about ticking the the remain box for those w …	X X PUNCT SCONJ DET PRON PRON AUX PART VERB PART SCONJ PRON AUX AUX ADJ ADV ADV PUNCT ADV ADP VERB DET DET NOUN NOUN ADP PRON ADP PUNCT
I 'm not difficult I 'm just about my business !	PRON AUX PART VERB PRON AUX ADV ADP PRON NOUN PUNCT
@USER242 yea ca n't 😔	PROPN INTJ AUX PART VERB
Please shit the suck up	INTJ NOUN DET NOUN ADP
@USER425 < Kira is committing a crime himself . Everyone commits crimes , even the ones who keep crimes from being done . " L pressed >	PROPN PUNCT PROPN AUX VERB DET ADJ NOUN PUNCT PROPN PROPN NOUN PUNCT ADV DET NOUN PRON VERB NOUN SCONJ AUX ADJ PUNCT PUNCT PROPN NOUN PUNCT
Lake Wind Advisory in effect from 9 AM for Angelina , Cherokee , Nacogdoches , Sabine and San Augustine Counties #txwx URL1304	ADJ NOUN NOUN ADP NOUN ADP NUM NOUN ADP PROPN PUNCT PROPN PUNCT PROPN PUNCT PROPN CCONJ PROPN PROPN PROPN NOUN X
RT @USER98 : The #GRAMMYs red carpet will last for about another 2 / 3 hours . Ariana could come late , we 'll see .	X X PUNCT DET NOUN ADJ NOUN AUX VERB ADP ADP DET NUM PUNCT NUM NOUN PUNCT PROPN AUX VERB ADJ PUNCT PRON AUX VERB PUNCT
Treat me like a queen , buy me CERTAIN things , just show me how life pose to be 😏👌🏾	VERB PRON ADP DET NOUN PUNCT VERB PRON VERB NOUN PUNCT ADV VERB PRON ADV NOUN NOUN PART AUX ADJ
#LokerEvent Web Designer URL1001	PROPN PROPN NOUN SYM
I do n't think i really have a type , I think a type has me . All the same guys come for me 🤔	PRON AUX PART VERB PRON ADV VERB DET NOUN PUNCT PRON VERB DET NOUN VERB PRON PUNCT DET DET ADJ NOUN VERB ADP PRON SYM
Arts L1	PROPN X
' Repair Matters ' group hopes to empower people with fix it skills URL550	PUNCT PROPN PROPN PUNCT PROPN NOUN ADP VERB NOUN ADP PROPN PRON VERB X
@USER2073 @USER1698 Congratulations on being front page news !	PROPN ADJ NOUN ADP AUX ADJ NOUN NOUN PUNCT
@USER2274 Hhhahahh just take number 12 Then 😂😂	PROPN VERB ADV VERB NOUN NUM ADV SYM
RT @USER896 : Chris Brown started the trend of freestyle dancing to " young thug / future / rich homie quan " songs during his concerts . I see …	X X PUNCT PROPN PROPN VERB DET NOUN ADP PROPN NOUN PART PUNCT ADJ PROPN PUNCT NOUN PUNCT ADJ PROPN NOUN PUNCT VERB ADP PRON NOUN PUNCT PRON VERB PUNCT
RT @USER467 : Marcus Rashford dribbled past 3 players v #ISL . No player on the pitch managed more . He played for 5 f**king minutes . …	X X PUNCT PROPN PROPN NOUN ADJ NUM NOUN PROPN NOUN PUNCT DET NOUN ADP DET NOUN PROPN ADV PUNCT PRON VERB ADP NUM PROPN NOUN PUNCT PUNCT
Mf what ? URL619	VERB PRON PUNCT VERB
RT @USER10 : Indianapolis wicked wicked wicked vibes .. purple reign fanatics ☔️ love forever	X X PUNCT PROPN PROPN NOUN PROPN NOUN PUNCT PROPN PROPN PROPN NOUN NOUN ADV
@USER86 @USER979 such a basic but difficult mission .	PROPN VERB DET DET NOUN CCONJ ADJ NOUN PUNCT
Lol girls are funny	INTJ NOUN AUX ADJ
I am streaming on #BIGOLIVE . Join now ! URL764 URL284	PRON AUX VERB ADP PROPN PUNCT VERB ADV PUNCT X SYM
@USER1109 @USER538 @USER266 I have not . Should I ? URL1098	PROPN PROPN PROPN PRON VERB PART PUNCT AUX PRON PUNCT X
@USER2569 thank you :)	PROPN VERB PRON SYM
RT @USER472 : Me : I 'm really tryin to save money Friends : let 's all go out to eat Me : URL1299	X X PUNCT PRON PUNCT PRON AUX ADV ADJ PART VERB NOUN X PUNCT VERB AUX DET VERB ADV PART VERB PRON PUNCT X
RT @USER1584 : " I 'm always having to look over my shoulder . " Why we 're still talking about racism : URL599	X X PUNCT PUNCT PRON AUX ADV VERB PART VERB ADP PRON NOUN PUNCT PUNCT ADV PRON AUX ADV VERB ADP PROPN PUNCT X
can someone get me gars i have the money lol	AUX PRON VERB PRON VERB PRON VERB DET NOUN INTJ
RT @USER1753 : No lie GSU was lit on this night #GSU #StateNotSouthern URL368	X X PUNCT DET NOUN NOUN AUX VERB ADP DET NOUN PROPN NOUN X
RT @USER295 : Senegal 's Lake Retba owes its pink color to the presence of carotenoids produced by an algae . #Senegal #funfacts URL221 …	X X PUNCT PROPN PART ADJ PROPN VERB PRON ADJ NOUN ADP DET NOUN ADP PROPN VERB ADP DET NOUN PUNCT PROPN X X PUNCT
@USER166 remove the words " with men on base "	PROPN VERB DET NOUN PUNCT ADP NOUN ADP PROPN PUNCT
Revealed Radio 070 - The Chainsmokers and Hardwell URL1042 🔥🙌👏	PROPN PROPN PROPN PUNCT DET NOUN CCONJ NOUN NOUN X
Got these beauties today from @USER124 🌙💋 URL315	VERB DET ADJ NOUN ADP PROPN PROPN X
RT @USER1192 : drunk texts are cute because while their mind is n't functioning correctly , you 're still on it	X X PUNCT PROPN NOUN AUX ADJ SCONJ SCONJ PRON NOUN AUX PART ADJ NOUN PUNCT PRON AUX ADV ADP PRON
I 'm artistic you niggas are autistic retarted 🙄	PRON AUX VERB PRON NOUN AUX ADJ SYM SYM
RT @USER1761 : Bad habit : staying up all night thinking about someone whos probably thinking about som …	X X PUNCT ADJ NOUN PUNCT VERB ADP DET NOUN VERB ADP PRON NOUN ADV VERB ADP PROPN PUNCT
Great chance to nominate the best & brightest from our AMC community ! URL1351 #assnchat #assnprofs	ADJ NOUN PART VERB DET ADJ CCONJ ADJ ADP PRON ADJ NOUN PUNCT VERB NOUN X
Your Local Doppler Radar URL891 #roundrock	PRON PROPN PROPN PROPN NOUN X
RT @USER1625 : 68 . my girl getting all dolled up 😍 URL1113	X X PUNCT PROPN PUNCT PRON NOUN VERB DET NOUN ADP SYM X
Just posted a photo URL1284	ADV VERB DET NOUN X
📷 Purchase my special edition of Alternative Revolution Magazine at URL748 URL888	SYM VERB PRON ADJ NOUN ADP PROPN PROPN PROPN ADP PROPN X
RT @USER1005 : She is on another level 😍 URL586	X X PUNCT PRON AUX ADP DET NOUN SYM X
I 'm craving the parlor soooo bad	PRON AUX VERB DET NOUN NOUN ADJ
@USER2636 i m only 65 days from taking over	PROPN PRON AUX ADV ADJ NOUN ADP VERB ADP
imagine being able to budget that must be so nice	PRON AUX ADJ PART VERB SCONJ AUX AUX ADV ADJ
A3174 [ NEW ] Authorizes special striped bass license plate . URL879	PROPN PUNCT ADJ PUNCT PROPN ADJ PROPN PROPN PROPN NOUN PUNCT X
@USER2627 is so nice to me on Twitter but so mean on Instagram ??	PROPN AUX ADV ADJ ADP PRON ADP PROPN CCONJ ADV VERB ADP PROPN PUNCT
@USER1699 @USER843 POSSIBLEEEEEE , POSSILBEEEEEEEEEEEEEEEE . * chants " cousins " over and over again *	PROPN PROPN PROPN PUNCT PROPN PUNCT PUNCT PROPN PUNCT PROPN PUNCT ADV CCONJ ADV ADV PUNCT
He looks at me !! @USER1200 URL340	PRON VERB ADP PRON PUNCT X X
Yamaha ’s Rossi gets contract extension through 2018 : Valentino Rossi has extended his contract with Yamaha for ... URL849	PROPN PART VERB VERB NOUN NOUN ADP NUM PUNCT PROPN NOUN AUX VERB PRON NOUN ADP NOUN ADP PUNCT X
RT @USER326 : Gucci Mane is going on tour after being released from prison in September URL791	X X PUNCT PROPN NOUN AUX VERB ADP NOUN SCONJ AUX NOUN ADP NOUN ADP PROPN X
RT @USER702 : ' Jesus please mention my name when you talk to your Father today ... ' 🙏🏽	X X PUNCT PUNCT PROPN INTJ VERB PRON NOUN ADV PRON VERB ADP PRON NOUN NOUN PUNCT PUNCT SYM
@USER468 good , now they 'll make their own money and wo n't have to charge men for love . URL454	PROPN ADJ PUNCT ADV PRON AUX VERB PRON ADJ NOUN CCONJ AUX PART VERB PART VERB NOUN ADP NOUN PUNCT X
RT @USER451 : Naruto : Hey let 's go get some ramen !! Sasuke : shut up and get off my lawn , loser Itachi : now now Sasuke be nice URL221 …	X X PUNCT PROPN PUNCT INTJ VERB PART VERB VERB DET NOUN PUNCT X PUNCT VERB ADP CCONJ VERB ADP PRON NOUN PUNCT SYM X PUNCT ADV ADV PROPN AUX ADJ X PUNCT
BETFAIR - Bet £ 10 Get £ 30 + Double Winnings on Everton v Man Utd if both teams score URL242 #FACup URL1139	PROPN PUNCT PROPN SYM NUM VERB SYM NUM SYM PROPN NOUN ADP PROPN PROPN NOUN VERB SCONJ DET NOUN VERB NOUN NOUN X
RT @USER259 : Swervin thru my ends	X X PUNCT PROPN VERB PRON NOUN
Taylor Swift ‘s boyfriend Calvin Harris Injured In a Terrible Car Accident URL625 URL1436	PROPN PROPN PROPN NOUN PROPN PROPN NOUN ADP DET NOUN PROPN NOUN X X
what song -	PRON NOUN PUNCT
RT @USER139 : The first " haters will say it 's fake " video to make me laugh 😂 URL911	X X PUNCT DET ADJ PUNCT PROPN AUX VERB PRON AUX ADJ PUNCT NOUN PART VERB PRON VERB SYM X
RT @USER478 : CHAMPIONS !!!! URL1377	X X PUNCT PROPN PUNCT X
RT @USER2501 : ( credits to blackangel94a on tumblr ) URL1577	X X PUNCT PUNCT NOUN ADP VERB ADP PROPN PUNCT X
RT @USER2052 : qn : which artist do you want to collab with the most ? hansol : Any URL1628	X X PUNCT X PUNCT DET NOUN AUX PRON VERB PART VERB ADP DET ADJ PUNCT X PUNCT DET NOUN
@USER2460 Me too . Looking forward to the delivery tomorrow .	VERB PRON ADV PUNCT VERB ADV ADP DET NOUN NOUN PUNCT
It s a legit hustle URL408	PRON AUX DET NOUN NOUN X
RT @USER1425 : The UNCOMFORTABLE CONVERSATIONS series starts today !!! Make sure your there !!! @ LTB 5 , 6 - 8 PM . URL1048	X X PUNCT DET NOUN ADJ NOUN VERB NOUN PUNCT VERB ADJ PRON ADV PUNCT ADP PROPN NUM PUNCT NUM PUNCT NUM NOUN PUNCT X
'Cause I 'm as free as a bird now	PROPN PRON AUX SCONJ ADJ ADP DET NOUN ADV
Oh goddam nit I cried at work again	INTJ PROPN VERB PRON VERB ADP NOUN ADV
RT @USER2453 : @USER1838 good evening ! ( japan time ) ! Thank you very much ! Friendly Corina Dumitrescu 's ! Nature is Beautiful ! spen …	X X PUNCT PROPN ADJ NOUN PUNCT PUNCT PROPN NOUN PUNCT PUNCT VERB PRON ADV ADJ PUNCT ADJ NOUN NOUN PART PUNCT NOUN AUX ADJ PUNCT X PUNCT
Joebarly Feat. HitMaker Q – Widd It URL1474 Major #HipHop	PROPN VERB PROPN PROPN PUNCT PROPN PRON VERB ADJ NOUN
... Do n't look at me like that . You and I both know there 's nothing I can do .	PUNCT AUX PART VERB ADP PRON VERB PRON PUNCT PRON CCONJ PRON PRON VERB PRON AUX PRON PRON AUX VERB PUNCT
All I did was unpack my shoes / purses ... I feel like I unpacked a whole damn house 😨😖	SCONJ PRON AUX AUX VERB PRON NOUN PUNCT INTJ PUNCT PRON VERB SCONJ PRON VERB DET ADJ ADJ NOUN SYM
@USER1927 thank you for making sure that is exactly what is going to happen . #ARSAVL	PROPN VERB PRON ADP VERB ADJ PRON AUX ADV PRON AUX VERB PART VERB PUNCT X
Get Lost Moon for FREE on URL358 - your weekly game #giveaway #orlygift #steam #indi	VERB VERB NOUN ADP ADJ ADP NOUN PUNCT PRON ADJ NOUN NOUN NOUN NOUN X
RT @USER2284 : #Housing Shortages Stifle Sales Contracts URL1476 - more from @USER2379 #realestate #phs URL224 …	X X PUNCT PROPN PROPN ADJ NOUN PROPN NOUN PUNCT ADJ ADP PROPN NOUN X X PUNCT
lowkey obsessed with me before you	PROPN VERB ADP PRON SCONJ PRON
#DolceAmorePuSo TWEET BOOST ! NOW TRENDING ! DOLCE AMORE lsmlm	PROPN VERB PROPN PUNCT ADV PROPN PUNCT PROPN NOUN X
RT @USER1131 : Omg I 'm at this youtube party and these people write first impression judgments of you LOL @USER1327 URL1086 …	X X PUNCT INTJ PRON AUX ADP DET NOUN NOUN CCONJ DET NOUN VERB ADV ADJ VERB ADP PRON INTJ X X PUNCT
RT @USER2171 : To love someone is to see a miracle invisible to others . #ALDUBSeeYouSoon	X X PUNCT PART VERB PRON AUX PART VERB DET NOUN NOUN ADP NOUN PUNCT X
RT @USER1618 : This how you need to be thinking girls . URL500	X X PUNCT PRON ADV PRON VERB PART AUX VERB NOUN PUNCT X
RT @USER2272 : Most subscribed music artists on YouTube : # 1 Justin Bieber # 2 Rihanna # 3 One Direction # 4 Taylor Swift URL852 …	X X PUNCT ADJ ADJ NOUN NOUN ADP PROPN PUNCT NOUN NUM PROPN PROPN NOUN NUM PROPN NOUN NUM NUM NOUN NOUN NUM PROPN PROPN X PUNCT
RT @USER1778 : 10 Worst Feelings : Cheated on Over thinking Lied to Heart broken Not cared for Losing Scared Assuming Nervous Letting go	X X PUNCT NUM ADJ NOUN PUNCT VERB ADP SCONJ VERB VERB ADP NOUN VERB PART VERB SCONJ VERB ADJ VERB ADJ VERB VERB
RT @USER817 : The " Laugh at me one more time " starter pack URL357	X X PUNCT DET PUNCT VERB ADP PRON NUM ADJ NOUN PUNCT PROPN NOUN NOUN
Jessica watched @USER980 and his schemy little smirk before she rolled her hazel hues at his response . " I 'm glad I got your ~~	PROPN VERB VERB CCONJ PRON NOUN ADJ NOUN SCONJ PRON VERB PRON NOUN NOUN ADP PRON NOUN PUNCT PUNCT PRON AUX ADJ PRON VERB PRON NOUN
RT @USER1340 : I 'm the type of person to never get any sleep because all I do each night is overthink the smallest shit that shouldn ' …	X X PUNCT PRON AUX DET NOUN ADP NOUN PART ADV VERB DET NOUN SCONJ DET PRON VERB DET NOUN AUX VERB DET NOUN NOUN DET NOUN PUNCT PUNCT
RT @USER1413 : Ever eaten a banana with black spots ? This is what they 're doing to you : URL873	X X PUNCT ADV VERB DET NOUN ADP ADJ NOUN PUNCT PRON AUX PRON PRON AUX VERB ADP PRON PUNCT X
The Wrong Trousers #CowellsChildrensTitles	DET NOUN NOUN SYM
RT @USER2406 : Leigh Anne Pinnock URL1494	X X PUNCT PROPN PROPN NOUN X
RT @USER1988 : There is a difference between intuition & fear they both can serve as guides , but only the intuition feels comfortable	X X PUNCT PRON AUX DET NOUN ADV NOUN CCONJ NOUN PRON PRON AUX VERB ADP PROPN PUNCT CCONJ ADV DET NOUN ADJ ADJ
RT @USER383 : What ? You expect her to wear a suit at the beach ? URL1586	X X PUNCT PRON PUNCT PRON VERB PRON PART VERB DET NOUN ADP DET NOUN PUNCT X
RT @USER1634 : We want a #newsarunshow with @USER138 #BarunSobti & #SanayaIrani ( #Sarun ) on @USER1250 @USER1950 URL224 …	X X PUNCT PRON VERB DET NOUN ADP PROPN NOUN CCONJ NOUN PUNCT PROPN PUNCT ADP PROPN X X PUNCT
RT @USER2376 : every morning is a continuous cycle of wow i ca n't wait to go to bed tonight	X X PUNCT DET NOUN AUX DET NOUN NOUN ADP INTJ PRON AUX PART VERB PART VERB ADP NOUN NOUN
1,000,000 Real YouTube Views , $ 2000 !! URL524	PROPN ADJ PROPN PROPN PUNCT SYM PROPN PUNCT X
RT @USER1755 : Beer Director Greg Engert getting ready to taste some springtime brews on @USER1704 !	X X PUNCT PROPN PROPN PROPN NOUN AUX ADJ PART VERB DET NOUN NOUN ADP PROPN PUNCT
RT @USER916 : Found some cool fans at the @USER760 display who have NO idea I 'm about to surprise them w/ pre-race passes ! 🎉 - JW URL0 …	X X PUNCT VERB DET ADJ NOUN ADP DET NOUN NOUN PRON VERB ADJ NOUN PRON AUX ADP PART VERB PRON ADP PROPN PROPN PUNCT SYM PUNCT PROPN X PUNCT
RT @USER1960 : Uncountable ! #ServicesByMSG . Are going Onn Across The Globe under HIS HOLINESS @USER530 ' :-) URL1360	X X PUNCT PROPN PUNCT PROPN PUNCT AUX VERB VERB VERB DET NOUN VERB PRON ADJ X PUNCT SYM X
RT @USER291 : I love this cat . URL1120	X X PUNCT PRON VERB DET NOUN PUNCT X
#VeranoMTV2016 5 Seconds of Summer 16	X NUM NOUN ADP NOUN NUM
RT @USER2282 : HARRY IS STRONG BUT CA N'T EVEN OPEN A BAG OF GOLDFISH URL389	X X PUNCT PROPN AUX ADJ NUM PROPN PROPN PROPN VERB DET NOUN ADP NOUN X
North Ends getting a theatre 🤘🏻😍 URL819	PROPN PRON VERB DET NOUN NOUN X
RT @USER2394 : 26 . dick and dom in da bungalow they were just discount ant and dec but i loved it anyway URL1270	X X PUNCT NUM PUNCT NOUN CCONJ NOUN ADP DET NOUN PRON AUX ADV VERB NOUN CCONJ NOUN CCONJ PRON VERB PRON ADV SYM
k but @USER2313 is legit cute af so I 'm confused 😩	NUM CCONJ PROPN AUX ADJ ADJ NOUN ADV PRON AUX ADJ SYM
#pray Jehovah Sabaoth restore Jamaican lady 's privacy Completely & vindicate her sanity & reports of thugs ' 24 hr stalking & eavesdroppin IJN	PROPN PROPN PROPN PROPN PROPN NOUN PART ADJ NOUN CCONJ VERB PRON NOUN CCONJ VERB ADP PROPN PUNCT NUM PROPN NOUN CCONJ NOUN NOUN
Like 8 hours ago URL1579	ADP NUM NOUN ADV SYM
Why are you turning on me ???	ADV AUX PRON VERB ADP PRON PUNCT
RT @USER1402 : This is a real fight URL609	X X PUNCT PRON AUX DET ADJ NOUN SYM
RT @USER2510 : Chelsea owner Roman Abramovich having second thoughts about Jose ... URL723 #Pep_Guardiola #Jose_Mourinho	X X PUNCT PROPN NOUN NOUN NOUN VERB ADJ NOUN ADP PROPN PUNCT PROPN NOUN X
Wife Catches Her Husband With Mistress And Beats The Hell Out Of Her ( Photos ) URL627	PROPN VERB PRON NOUN ADP NOUN CCONJ VERB DET NOUN ADV ADP PRON PUNCT PROPN PUNCT X
Time to Make your #MomentsThatCount at #NissanPavilion by having a glimpse of ICC T20 trophy watch here >>> URL1604	NOUN PART VERB PRON NOUN ADP PROPN SCONJ VERB DET NOUN ADP PROPN PROPN PROPN VERB ADV VERB X
WWW #MTVHottest Little Mix	PROPN PROPN PROPN NOUN
Our brand new Moon Babe with hair buns in the beauteous home of @USER1630 | Available … URL1186	PRON NOUN ADJ NOUN VERB ADP NOUN NOUN ADP DET NOUN NOUN ADP PROPN SYM NUM PUNCT X
👉 URL501 👈 Real women to sex with ✅ Fully free now 🔞 #anikka #angelina #analporn #animation	PROPN PROPN PROPN ADJ NOUN PART NOUN ADP PROPN PROPN ADJ ADV PROPN PROPN PROPN NOUN X
I got a traveler insta it 's fr just pictures I 've shot while traveling n exploring do n't have to follow me but just take a peek ig : stevoohhh	PRON VERB DET NOUN VERB PRON AUX ADJ ADV NOUN PRON AUX VERB SCONJ NOUN CCONJ NOUN AUX PART VERB PART VERB PRON CCONJ ADV VERB DET NOUN NOUN PUNCT X
Tory Lanez - Say It URL479 #hiphop #music #Verified #rt	PROPN PROPN PUNCT VERB PRON VERB PROPN X X NOUN
RT @USER597 : Résumé : Makes $ 35 k a year but will break your kindergartner 's ankles URL573	X X PUNCT PROPN PUNCT PROPN SYM PROPN NUM DET NOUN CCONJ AUX VERB PRON NOUN PART ADJ SYM
themselves as russian URL782	PRON ADP PROPN X
@USER402 makeup revolution basically dupes high end makeup it 's where I get all my stuff lmao	PROPN NOUN NOUN NUM PROPN ADJ NOUN NOUN PRON AUX ADV PRON VERB DET PRON NOUN INTJ
RT @USER2206 : when the people you thought are quiet pero dili diay orayt URL760	X X PUNCT ADV DET NOUN PRON VERB AUX ADJ PROPN PROPN NOUN X X
RT @USER1589 : Me Myself and I by G Eazy | Cover by Alex Aiono : URL361 via @USER1490	X X PUNCT PRON VERB CCONJ PRON ADP X PROPN SYM NOUN ADP PROPN X PUNCT PROPN ADP PROPN
@USER500 haha that 's so cool !! I plan on getting a cap shield eventually when I have money to blow . Tweet a pic of the suit !!	PROPN INTJ PRON AUX ADV ADJ PUNCT PRON VERB SCONJ VERB DET NOUN PROPN VERB ADV PRON VERB NOUN PART VERB PUNCT VERB DET NOUN ADP DET NOUN PUNCT
BJ the Chicago Kid Talks Kendrick Lamar & Repping the ' New R&B ' on Motown Debut Album : Moving to Los Angeles a ... URL772	VERB DET PROPN PROPN PROPN PROPN NOUN CCONJ VERB DET PUNCT ADJ PROPN PUNCT ADP PROPN PROPN NOUN PUNCT VERB PART VERB PROPN DET PUNCT X
@USER2150 @USER2103 I need to check this out ! Thanks #saskedchat	PROPN PROPN PRON VERB PART VERB PRON ADP PUNCT NOUN X
RT @USER2231 : We are live now !!!! URL1389 URL1033	X X PUNCT PRON AUX ADJ ADV PUNCT X NOUN
RT @USER2409 : #KanhaiyaKumar bail plea #adjourned to Feb. 29 URL814 URL443	X X PUNCT PROPN PROPN NOUN NOUN ADP PROPN NUM NOUN X
RT @USER1443 : " Can i have a bite " Me : URL1243	X X PUNCT PUNCT AUX PRON VERB DET NOUN PUNCT PRON PUNCT X
RT @USER128 : Look at that face . The joys of being a parent URL730	X X PUNCT VERB ADP DET NOUN PUNCT DET NOUN SCONJ AUX DET NOUN X
RT @USER2590 : in the mood for a long drive with no destination	X X PUNCT ADP DET NOUN ADP DET ADJ NOUN ADP DET NOUN
RT @USER161 : throwback to this amazing performance URL1108	X X PUNCT VERB ADP DET ADJ NOUN NOUN
RT @USER1713 : I find this hilarious in its appalling-ness for a number of reasons . URL1358	X X PUNCT PRON VERB PRON ADJ ADP PRON NOUN ADP DET NOUN ADP NOUN PUNCT X
RT @USER1527 : Very hot ! URL423	X X PUNCT ADV ADJ PUNCT X
RT @USER959 : #NewportNews #Virginia boy leaves Gatorade , water for #LetterCarrier URL938 via @USER6 URL224 …	X X PUNCT PROPN ADJ NOUN VERB NOUN PUNCT VERB ADP PROPN NOUN ADP PROPN X PUNCT
The old niggas on Dr Dre album Lowkey be taking hella shots at the new niggas lol	DET ADJ NOUN ADP PROPN PROPN NOUN NOUN AUX VERB ADV NOUN ADP DET ADJ NOUN INTJ
RT @USER1874 : hi a lil reminder that u guys will meet dan & phil :~) URL1169	X X PUNCT INTJ DET ADJ NOUN SCONJ PRON NOUN AUX VERB PROPN CCONJ PROPN NOUN X
Egyptian writer Ahmed Naji ’s crime is n't what he wrote – it is that he is alive URL607	PROPN PROPN PROPN NOUN PART NOUN AUX PART PRON PRON VERB PUNCT PRON AUX PRON PRON AUX ADJ NOUN
RT @USER919 : Great setting for @USER1033 Falmouth GP of the Sea 2017 URL461	X X PUNCT ADJ VERB ADP PROPN PROPN PROPN ADP DET NOUN NUM NOUN
RT @USER1916 : hate getting flashbacks from things you do n't want to remember . it feels like your heart suddenly drops and anxiety starts …	X X PUNCT VERB VERB ADJ ADP NOUN PRON AUX PART VERB PART VERB PUNCT PRON VERB SCONJ PRON NOUN NOUN NOUN CCONJ NOUN VERB PUNCT
RT @USER1256 : " We need some payday lending reforms . " - Alabama Banking Department Superintendent John Harrison URL1181 …	X X PUNCT PUNCT PRON VERB DET NOUN PROPN NOUN PUNCT PUNCT PUNCT PROPN PROPN PROPN PROPN PROPN X X PUNCT
RT @USER2347 : For the highest ticket prices in world football , we 're ' entitled ' to expect more than zero PL / CL titles in 12 yrs . URL219 …	X X PUNCT ADP DET NOUN NOUN NOUN ADP NOUN NOUN PUNCT PRON AUX PUNCT PROPN PUNCT PART VERB ADJ ADP NUM NOUN PUNCT PROPN NOUN ADP NUM PROPN PUNCT X PUNCT
Now playing on OSN Radio ( @USER2325 ) Another Day ( Perfecto Mix ) by Skip Raiders #OSN #NowPlaying ( URL1112 )	ADV VERB ADP PROPN PROPN PUNCT PROPN PUNCT DET NOUN PUNCT PROPN NOUN PUNCT ADP PROPN PROPN X X PUNCT PROPN PUNCT
@USER2322 what	VERB PRON
Of course , as everyone knows Powers resigned from the campaign and retracted these comments . But now she 's US Ambassador to the UN .	ADV ADV PUNCT SCONJ PRON VERB PROPN NOUN ADP DET NOUN CCONJ VERB DET NOUN PUNCT CCONJ ADV PRON AUX PROPN NOUN ADP DET NOUN PUNCT
ugh I 'm so picky when it comes to dress shopping :(	INTJ PRON AUX ADV ADJ ADV PRON VERB PART VERB PROPN SYM
the video had an effect on me	DET NOUN VERB DET NOUN ADP PRON
Oh , and regex by @USER1783 . Do check out the slides . #NICAR16	INTJ PUNCT CCONJ VERB ADP PROPN PUNCT AUX VERB ADP DET NOUN PUNCT X
can hou shut up beacause yiur beeath stinka URL1440	AUX VERB VERB ADP PROPN PROPN PROPN X X
I just do n't understand how someone can change their mind so fast . You 're so disgusting	PRON ADV AUX PART VERB ADV PRON AUX VERB PRON NOUN ADV ADJ PUNCT PRON AUX ADV ADJ
Genocide in #Yemen yet world silence . Very strange : for US & #Europe , Yemen does n't exist ! Can You explain ? #ForgottenWarInYemen	NOUN ADP PROPN PROPN NOUN VERB PUNCT ADV NOUN PUNCT ADP PROPN CCONJ PROPN PUNCT PROPN AUX PART VERB PUNCT AUX PRON VERB PUNCT SYM
Jason Jordan just threw a dude	PROPN PROPN ADV VERB DET NOUN
If you cheat on someone that is willing to do anything for you , you actually cheated yourself out of true loyalty .	SCONJ PRON VERB ADP PRON PRON AUX ADJ PART VERB PRON ADP PRON PUNCT PRON ADV VERB PRON ADP ADP ADJ NOUN PUNCT
RT @USER1289 : FRIENDLY REMINDER THAT STILES STILINSKI AND ALLISON ARGENT DESERVED MORE SCENES TOGETHER URL905	X X PUNCT ADJ NOUN DET NOUN NOUN CCONJ PROPN NOUN PROPN ADJ NOUN X X
.... and guess who are paying the shortfall ! URL875	PUNCT CCONJ VERB PRON AUX VERB DET NOUN PUNCT X
RT @USER849 : TWITTER TEAM DOING PABEBE WAVE with @USER2199 STANDEE #VoteMaineFPP #KCA URL651	X X PUNCT PROPN NOUN PROPN NOUN NOUN ADP PROPN PROPN X X X
She wrote on a note attached " I do nt put my credit card info on the internet " 😭😂😭😂 I love her old ass man .	PRON VERB ADP DET NOUN NOUN PUNCT PRON AUX PART VERB PRON NOUN NOUN NOUN ADP DET NOUN PUNCT VERB PRON VERB PRON ADJ NOUN NOUN PUNCT
RT @USER804 : not moving no nigga in my house , if ima do bad , ima do bad by my damn self !!! 👏🏾	X X PUNCT PART VERB DET NOUN ADP PRON NOUN PUNCT SCONJ VERB VERB ADJ PUNCT VERB AUX ADJ ADP PRON ADJ NOUN PUNCT X
RT @USER1550 : “ Current mood and most of the days mood . “ URL695	X X PUNCT PUNCT PROPN NOUN CCONJ ADJ ADP DET NOUN NOUN PUNCT PUNCT SYM
RT @USER548 : As far as I 'm aware , the doors are open . And we 're On The Road Again .	X X PUNCT SCONJ ADJ SCONJ PRON AUX VERB PUNCT DET NOUN AUX ADJ PUNCT CCONJ PRON AUX ADP DET NOUN NOUN PUNCT
@USER1359 what about a drink of liquid nitrogen ?	VERB PRON ADP DET NOUN ADP PROPN PROPN PUNCT
RT @USER573 : Angela Eagle : I went to Uni thanks to a Labour Govt Govt when Angela Eagle went to Uni : Thatcher ( Graduated in 1983 , St …	X X PUNCT PROPN NOUN PUNCT PRON VERB ADP ADJ NOUN ADP DET NOUN PROPN VERB ADV ADJ NOUN VERB ADP PROPN PUNCT PROPN PUNCT PROPN ADP PROPN PUNCT PROPN PUNCT
Sames URL1428	PROPN PROPN
RT @USER399 : .. rabbits in there . Told me they were mine to love and care for . Even hired this guy to help me feed em and clean the pen . Be …	X X PUNCT PUNCT VERB ADP PRON PUNCT VERB PRON PRON AUX PRON PART VERB CCONJ VERB ADP PUNCT ADV VERB DET NOUN PART VERB PRON VERB PRON CCONJ VERB DET NOUN PUNCT AUX PUNCT
@USER2275 Careful with that porcelain skin . sweetie !	PROPN VERB ADP DET ADJ NOUN PUNCT PROPN PUNCT
RT @USER474 : Character progression through all 10 seasons of Friends ... URL378	X X PUNCT PROPN NOUN ADP DET NUM NOUN ADP PROPN PUNCT X
RT @USER905 : rt if you grew up on these streets URL1061	X X PUNCT VERB SCONJ PRON VERB ADP ADP DET NOUN X
RT @USER213 : Funding legal services focus of AG ’s pre-election debate URL513 via @USER2151	X X PUNCT PROPN PROPN NOUN NOUN ADP NOUN PART VERB NOUN NOUN ADP PROPN
RT @USER1172 : I agree with and support President Putin ! He 's right . URL1329	X X PUNCT PRON VERB ADP CCONJ NOUN NOUN NOUN PUNCT PRON AUX ADJ PUNCT SYM
RT @USER689 : This is perhaps the most succinct and accurate sentence regarding Trumps ' popularity I have ever read . URL1157 …	X X PUNCT PRON AUX VERB DET ADJ NOUN CCONJ VERB PROPN PROPN PROPN PUNCT PROPN PRON VERB ADV VERB PUNCT PROPN PUNCT
See you again #TSOUAwkward	VERB PRON ADV SYM
RT @USER480 : I got a new one for you guys URL719	X X PUNCT PRON VERB DET ADJ NOUN ADP PRON NOUN SYM
#VOZEMPIRE : Ready to Divorce ? David Beckham Resigned From Victoria ’s Fashion Company URL360	PROPN PUNCT NOUN ADP PROPN PUNCT PROPN PROPN NOUN ADP PROPN PART NOUN NOUN X
If you can meditate , then you can achieve your smallest desires in life as meditation helps you shed light on every little information !	SCONJ PRON AUX VERB PUNCT SCONJ PRON AUX VERB PRON NOUN NOUN ADP NOUN SCONJ NOUN VERB PRON VERB NOUN ADP DET ADJ NOUN PUNCT
RT @USER286 : Early Bird tickets are now Sold Out !! Get your #CountryFlo passes while supplies last : URL453 URL220 …	X X PUNCT PROPN PROPN NOUN AUX ADV VERB SCONJ PUNCT VERB PRON NOUN NOUN ADP NOUN ADJ PUNCT X X PUNCT
He said the shit stank	PRON VERB DET NOUN NOUN
RT @USER877 : and yes there are biblical references to the ' insignificance ' of women . BUT there 's just as many to our significance a …	X X PUNCT CCONJ INTJ PRON AUX ADJ NOUN ADP DET PUNCT PROPN PUNCT ADP NOUN PUNCT CCONJ PRON AUX ADV ADP ADJ ADP PRON VERB DET PUNCT
RT @USER650 : ALL THESE VIP PEEPS IN MY MENTIONS IT S LIT 😍	X X PUNCT DET PRON PROPN VERB ADP PRON VERB PRON VERB X SYM
RT @USER1312 : we startin to bark viciously	X X PUNCT PRON VERB ADP VERB SYM
RT @USER515 : " It does n't matter how much you have . It all means nothing if you are not happy with yourself . " Donald Duck #quotes htt …	X X PUNCT PUNCT PRON AUX PART VERB ADV ADV PRON VERB PUNCT PRON DET VERB PRON SCONJ PRON AUX PART ADJ ADP PRON PUNCT PUNCT PROPN PROPN X X PUNCT
pursuing the opposite : complain against EU red tape --> Seek EXCEPTIONAL treatment --> Get ever more red tape @USER2384 URL417	VERB DET NOUN PUNCT PROPN ADV VERB ADJ NOUN SYM PROPN PROPN PROPN SYM VERB ADV ADV ADJ NOUN NOUN X
. @USER217 explains why Lincoln 's way is the future of luxury motoring : URL1102 URL299	PUNCT PROPN PROPN ADV PROPN PART NOUN AUX DET NOUN ADP PROPN X PUNCT X NOUN
RT @USER19 : They 're getting 1 k RTs per minute ... Start spamming if you do n't want their lead to increase . #Harmonizers #iHeartAwards …	X X PUNCT PRON AUX VERB NUM NUM NOUN PROPN PROPN PUNCT VERB VERB SCONJ PRON AUX PART VERB PRON NOUN PART VERB PUNCT X X PUNCT
Jewellery belonging to the Duchess of Windsor was auctioned today in 1987 in Geneva , raising £ 31 M for medical research .	NOUN NOUN ADP DET NOUN ADP PROPN AUX ADJ NOUN ADP NOUN ADP PROPN PUNCT PROPN SYM PROPN NOUN ADP ADJ NOUN PUNCT
Middle - Eastern relationships will go through the roof URL994	PROPN PUNCT PROPN NOUN AUX VERB ADP DET NOUN NOUN
RT @USER2192 : 11 Selfies that will make you uncomfortable . URL1273 URL1530	X X PUNCT NUM PROPN PRON AUX VERB PRON VERB PUNCT PROPN NOUN
#porn More free @ URL1029 No Tricks ! #gayporn #gaygif #chaturbate #gayvideo URL1477	PROPN ADJ ADJ ADP PROPN DET NOUN PUNCT PROPN PROPN NOUN NOUN X
I liked a @USER1490 video URL986 LIQUID LIPSTICKS YOU NEED !!!	PRON VERB DET PROPN NOUN PROPN NOUN VERB PRON VERB PUNCT
Disastorus first innigs SL performed very well 2nd innings lead by 33 runs 3 wickets left for SL #ENGvSL	PROPN ADJ PROPN PROPN PROPN ADV ADV ADJ NOUN NOUN ADP PROPN NOUN NUM NOUN VERB ADP PROPN NOUN
@USER2482 exactly , just go ahead !!!	PROPN ADV PUNCT ADV VERB ADV PUNCT
#NowPlaying Meathook Seed URL910	X PROPN NOUN NOUN
RT @USER132 : JDR did n't really address Mario Edwards being cleared ... he 's excited that Mario is part of team on the field .	X X PUNCT PROPN AUX PART ADV ADJ PROPN NOUN AUX NOUN PUNCT PRON AUX VERB SCONJ NOUN AUX NOUN ADP NOUN ADP DET NOUN PUNCT
RT @USER2186 : chill date ideas URL419	X X PUNCT ADJ NOUN NOUN X
" Sorry I ca n't work on July 9th because everyone is leaving Hamilton & I 'm emotionally invested in their existence . "	PUNCT INTJ PRON AUX PART VERB ADP PROPN PROPN SCONJ PRON AUX PROPN PROPN CCONJ PRON AUX ADJ VERB ADP PRON NOUN PUNCT PUNCT
Listen to 4 - Ayo Remix Rough by Yung 4 ( fooeee ) #np on #SoundCloud URL568	VERB ADP NUM PUNCT PROPN PROPN NOUN ADP PROPN NUM PUNCT PROPN PUNCT X ADP PROPN X
RT @USER0 : YOU ARE A WITCH ! Mariah Carey 's Brother Calls Her Out For Not Helping With Dying Sister 's URL1410 URL217 …	X X PUNCT PRON AUX DET NOUN PUNCT PROPN NOUN PART ADJ VERB PRON ADV ADP PART NOUN ADP PROPN PROPN PART ADJ X PUNCT
RT @USER2035 : JaDine Day . DNP 's First Day Gross . This Time 's First Day Gross 15 . 15M . 15M . All with 15 💜 Ang saya ulitin . 😹 #ThisTi …	X X PUNCT PROPN NOUN PUNCT PROPN PART ADJ NOUN PROPN PUNCT DET NOUN PART ADJ NOUN PROPN NUM PUNCT PROPN PUNCT PROPN PUNCT DET ADP NUM SYM PROPN PROPN PROPN PUNCT SYM PROPN PUNCT
RT @USER1377 : Can we give respectability to those who want to break India ? Arun Jaitley in Rajya Sabha #AfzalDebate URL595	X X PUNCT AUX PRON VERB NOUN ADP PRON PRON VERB PART ADJ PROPN PUNCT PROPN NOUN ADP PROPN PROPN X X
RT @USER785 : Hi from us @USER1759 ( excuse the insta spam ) URL980	X X PUNCT INTJ ADP PRON NOUN PUNCT VERB DET NOUN VERB PUNCT X
RT @USER1979 : Go on URL1144 and comment a ❤️ on any photo so I know it 's you !! URL235	X X PUNCT VERB ADP NOUN CCONJ VERB DET ADJ ADP DET NOUN ADV PRON VERB PRON AUX PRON PUNCT X
Money on my mind .. Money on my mind , so money is all I think of .	NOUN ADP PRON NOUN PUNCT NOUN ADP PRON NOUN PUNCT ADV NOUN AUX DET PRON VERB ADP PUNCT
Rattled Bangladesh run into resurgent India #IndiavsBangladesh ... #IndiavsBangladesh URL1115	PROPN PROPN VERB ADP PROPN PROPN PROPN PUNCT X X
@USER762 always here :)	PROPN ADV ADV SYM
Although your friendly nature usually puts others at ease , muc ... More for Libra URL430	SCONJ PRON NOUN NOUN PROPN NOUN NOUN ADP PROPN PUNCT PROPN PUNCT ADJ ADP NOUN X
RT @USER607 : found some tires URL1025	X X PUNCT VERB DET NOUN X
if they announce dates here i will record myself bawling for your entertainment	SCONJ PRON VERB NOUN ADV PRON AUX VERB PRON NOUN ADP PRON NOUN
#Mention Brett McDanel Art @USER2221 #bizitalk #uniqueart URL1345 #business	PROPN PROPN PROPN NOUN PROPN PROPN PROPN NOUN NOUN
RT @USER1910 : @USER1910 get off @USER1352 URL1376	X X PUNCT PROPN VERB ADP NOUN X
#group sex party porn anal dating URL1068	PROPN NOUN NOUN PROPN PROPN VERB X
🔞 on the 13th 😴	VERB ADP DET NOUN SYM
RT @USER1104 : Directors and CEOs from top Multinational companies meeting in a conference held at Gurugram . ( 2016 ) URL369 …	X X PUNCT VERB CCONJ VERB ADP NOUN PROPN NOUN NOUN ADP DET NOUN VERB ADP PROPN PUNCT PUNCT NUM PUNCT PROPN PUNCT
Do n't just be , make a difference	AUX PART ADV AUX PUNCT VERB DET NOUN
Broken Vows by English Artist Philip Calderon . Nice Canvas Art Print . Size 11 x 14 URL639 URL1110	PROPN VERB ADP ADJ NOUN PROPN NOUN PUNCT PROPN PROPN NOUN NOUN PUNCT NOUN NUM SYM NUM PROPN X
RT @USER1457 : Where URL978	X X PUNCT ADV ADJ
@USER1273 @USER215 be thankful it 's only 1 k ... Double or triple that for LA .	PROPN PROPN AUX VERB PRON AUX ADV NUM NUM PUNCT VERB CCONJ VERB PRON ADP PROPN PUNCT
@USER1757 Your Twitterettes are doing fine .	VERB PRON NOUN AUX VERB ADJ PUNCT
basketball bitch	PROPN NOUN
You can either sit and dwell on all the negative shit ... Or you can thank god you 're alive 'n blessed !!	PRON AUX ADV VERB CCONJ VERB ADP DET DET ADJ NOUN PUNCT CCONJ PRON AUX VERB PROPN PRON AUX ADJ ADJ VERB PUNCT
RT @USER26 : Dio - Rainbow In The Dark !! URL1388	X X PUNCT PROPN PUNCT PROPN ADP DET NOUN PUNCT X
RT @USER482 : 3 years ago today ... The best guard of honour EVER ! #mufc URL422	X X PUNCT NUM NOUN ADV NOUN PUNCT DET ADJ VERB ADP PROPN PROPN PUNCT X X
RT @USER1299 : Behind the scenes . Rick and Daryl #TheWalkingDead URL359	X X PUNCT VERB DET NOUN PUNCT PROPN CCONJ NOUN NOUN X
#NowPlaying Work by Rihanna ♫ URL603	X VERB ADP PROPN SYM X
RT @USER2107 : never want to disappoint you	X X PUNCT ADV VERB PART VERB PRON
@USER1582 @USER1801 @USER1146 is logic . She leads in Alba , would connect across generations . She can also check Nic Sturgeon	PROPN PROPN NOUN AUX NOUN PUNCT PRON VERB ADP PROPN PUNCT AUX ADJ ADJ NOUN PUNCT PRON AUX ADV VERB PROPN NOUN
RT @USER207 : BTS Summer Package in Dubai : Photobook , DVD , 2 mini poster , Zipperbag , Beach ball , Tattoo stickers , Charm accessory htt …	X X PUNCT PROPN NOUN NOUN ADP PROPN PUNCT PROPN PUNCT PROPN PUNCT NUM ADJ NOUN PUNCT PROPN PUNCT ADJ NOUN PUNCT PROPN NOUN PUNCT PROPN X X PUNCT
@USER2661 @USER687 yeah . Looks like he is like Wakefield , in the US calling himself doctor when he has no right to the title .	PROPN PROPN INTJ PUNCT VERB SCONJ PRON AUX ADP PROPN PUNCT ADP DET PROPN PROPN PROPN PROPN ADV PRON VERB DET ADJ ADP DET NOUN PUNCT
@USER931 it 's wild I promise you	VERB PRON AUX VERB PRON VERB PRON
iOrange -E 10 ft Strongest Kevlar Fiber Lightning Cable and Retractable Lightning Cable from $ 9.99 AC @USER83 URL715	PROPN PROPN NUM VERB PROPN PROPN PROPN PROPN NOUN CCONJ VERB NOUN NOUN ADP SYM PROPN PROPN X X
RT @USER338 : " You 're all racists ! " " Actually , I just prefer democracy to a remote , self - serving ... " " Shut up ! Shut up ! Racist ! " Etc.	X X PUNCT PUNCT PRON AUX DET NOUN PUNCT PUNCT PUNCT ADV PUNCT PRON ADV VERB ADJ ADP DET NOUN PUNCT NOUN PUNCT PROPN PUNCT PUNCT PUNCT VERB ADP PUNCT VERB ADP PUNCT PROPN PUNCT PUNCT SYM
RT @USER598 : Bryson Tiller had a 1 hell of a year	X X PUNCT PROPN NOUN VERB DET NUM NOUN ADP DET NOUN
RT @USER1766 : A fan account 's love of you is quantifiable by the amount of reblogged ugly pictures they think you look good in . #ThenkUA …	X X PUNCT DET NOUN NOUN PART VERB SCONJ PRON AUX VERB ADP DET NOUN ADP PROPN ADJ NOUN PRON VERB PRON VERB ADJ ADP PUNCT X PUNCT
@USER1830 Now there 's a quote	PROPN ADV PRON AUX DET NOUN
Just take a normal pic of yourself and filter it black and white , that 's your gear , hahaha URL287	ADV VERB DET ADJ NOUN ADP PRON CCONJ VERB PRON ADJ CCONJ ADJ PUNCT PRON AUX PRON NOUN PUNCT SYM X
He fresh w the dad jeans 💀 URL541	PRON VERB ADP DET NOUN PROPN NOUN X
RT @USER2485 : 2 BRAND NEW #Decay designs are available right now @ URL830 buy now for 20 % off URL464	X X PUNCT NUM PROPN ADJ NOUN NOUN AUX ADJ ADV ADV ADP PROPN VERB ADV ADP NUM SYM ADP NOUN
best friend forever he said	ADJ NOUN ADV PRON VERB
Doncaster Phoenix too good for West Hartlepool - Hartlepool Mail #Doncaster URL1585	PROPN NOUN ADV ADJ ADP PROPN PROPN PUNCT PROPN NOUN X X
RT @USER1313 : Here 's some motivation !! GO HARD GUYS #5SOSFam #BestFanArmy #iHeartAwards URL1466	X X PUNCT ADV AUX DET NOUN PUNCT VERB VERB NOUN X X X X
@USER709 @USER2377 NO THANKS NO MORE FOX ! ENJOY YOUR DEVOTED TIME TO THE MAN WHO WILL NOT GET THE FEMALE VOTE FOR PRESIDENT	PROPN PROPN DET NOUN DET ADJ NOUN PUNCT VERB PRON VERB NOUN ADP DET NOUN PRON AUX PART VERB DET NOUN NOUN ADP NOUN
@USER229 If you are you interested in True Esoteric teachings , check URL954	VERB SCONJ PRON AUX PRON ADJ ADP PROPN PROPN PROPN PUNCT VERB X
RT @USER2477 : Things that happened last Saturday & Sunday . Kath & DJ are nt lucky , they 're blessed . #VoteKathrynFPP #KCA URL708 …	X X PUNCT NOUN PRON VERB ADJ PROPN CCONJ PROPN PUNCT PROPN CCONJ PROPN AUX PART ADJ PUNCT PRON AUX VERB PUNCT PROPN X X PUNCT
I run yo brain around the block to jog your fuckin memory	PRON VERB INTJ NOUN ADP DET NOUN PART VERB PRON NOUN NOUN
Curry finishes , passes , & averages 2+ steals a game ..... URL698	PROPN PROPN PUNCT PROPN PUNCT CCONJ VERB VERB VERB DET NOUN PUNCT X
RT @USER84 : Three years after @USER1663 died , I wrote a thing . About death and drugs and stigma . You can read it here . URL219 …	X X PUNCT NUM NOUN ADP PROPN PROPN PUNCT PRON VERB DET NOUN PUNCT ADP NOUN CCONJ NOUN CCONJ NOUN PUNCT PRON AUX VERB PRON ADV PUNCT X PUNCT
Girls all became annoying when they just wanted to " Slayyy , yas bitch , mom 😍 , fabulous , FIERCE , omg slay my fucking life " stfu lol	NOUN DET NOUN ADJ ADV PRON ADV VERB PART PUNCT PROPN PUNCT ADJ NOUN PUNCT NOUN SYM PUNCT PROPN PUNCT PROPN PUNCT INTJ VERB PRON ADJ NOUN PUNCT PROPN INTJ
@USER2512 have shared the details . Expecting a call back from you .	PROPN VERB VERB DET NOUN PUNCT VERB DET NOUN ADV ADP PRON PUNCT
RT @USER2353 : Man I do n't feel like being at school	X X PUNCT NOUN PRON AUX PART VERB PRON AUX ADP NOUN
RT @USER2410 : 2/50 slightly behind Ashamed to say it 's taken me this long to find the time to sit and … URL552	X X PUNCT PROPN NOUN ADP NOUN PART VERB PRON AUX VERB PRON PRON ADJ PART VERB DET NOUN PART VERB CCONJ PUNCT X
@USER1591 my bad lol	VERB PRON ADJ INTJ
MCGI : RT aiefrel : A million thanks to God for all the things that He has done to us ! To GOD be the Glory :) #MCGIEndlessThanksgiving	PROPN PUNCT X X PUNCT DET NUM NOUN PART PROPN ADP DET DET NOUN SCONJ PRON AUX ADJ ADP PRON PUNCT ADP PROPN AUX DET NOUN SYM X
RT @USER714 : Baby chimpanzee 🐵 URL1478	X X PUNCT PROPN NOUN NOUN X
I 'm ready to take the next step God .	PRON AUX ADJ PART VERB DET ADJ NOUN PROPN PUNCT
I 've finished the Bartolomeo 's Orders quest ! Are you able to fulfil the same task ? URL810 #android , #androidgames , #gam ...	PRON AUX VERB DET NOUN PART ADJ NOUN PUNCT AUX PRON ADJ PART VERB DET ADJ NOUN PUNCT PROPN PROPN PUNCT PROPN PUNCT PROPN PUNCT
Reunited gon na win this #ThePlaysLaunch	PROPN VERB PART VERB PRON NOUN
RT @USER1508 : Do you ever realize Sounds Live Feels Live Starts this month and just URL979	X X PUNCT AUX PRON ADV VERB VERB ADV PROPN ADV VERB DET NOUN CCONJ ADV VERB
RT @USER561 : The safety of our kids is more important than the interests of the NRA . Our leaders should act like it . URL851 …	X X PUNCT DET NOUN ADP PRON NOUN AUX ADV ADJ ADP DET NOUN ADP DET NOUN PUNCT PRON NOUN AUX VERB ADP PRON PUNCT X PUNCT
RT @USER1871 : 160308 NATURE REPUBLIC FANSIGN IN BANGKOK Picture of u #SEHUN URL1573	X X PUNCT PROPN PROPN NOUN NOUN ADP PROPN NOUN ADP PRON VERB X
RT @USER1538 : You bitches do the MOST for less 😂😂😂😂😴	X X PUNCT PRON NOUN VERB DET NOUN ADP ADJ NOUN
RT @USER2567 : 6 Things That You Did n't Know About The Fresh Prince Of Bel Air . >>> URL763 URL316	X X PUNCT NUM NOUN SCONJ PRON AUX PART VERB ADP DET ADJ PROPN ADP PROPN PROPN PUNCT PROPN NOUN X
@USER2659 ur album bout to be lit	PROPN PRON NOUN ADJ PART AUX ADJ
RT @USER2428 : This is CARI pm me at URL1018 I will give u her phone number to meet in USA . U must be 18+ . URL223 …	X X PUNCT PRON AUX ADJ NOUN PRON ADP PROPN PRON AUX VERB PRON PRON NOUN NOUN PART VERB ADP PROPN PUNCT PRON AUX AUX NOUN PUNCT X PUNCT
RT @USER2392 : Mysterious !!!	X X PUNCT PROPN PUNCT
RT @USER2278 : 95 % Discount on @USER1600 Secret Weapon #Trading Course & 6 Setups using #Ichimoku >> URL1373 ht …	X X PUNCT PROPN SYM NOUN ADP PROPN PROPN PROPN PROPN NOUN CCONJ NUM NOUN VERB PROPN PUNCT X X PUNCT
RT @USER1595 : follow everyone who retweets this URL1422	X X PUNCT VERB PRON PRON VERB PRON NOUN
Huawei P9 Release Date , Price and Specs - CNET : Huawei 's new P9 -- and its big brother , the P9 Plus -- have tw ... URL386	PROPN PROPN PROPN NOUN PUNCT PROPN CCONJ NOUN PUNCT PROPN PUNCT PROPN PART ADJ NOUN PUNCT CCONJ PRON ADJ NOUN PUNCT DET ADJ NOUN PUNCT VERB NOUN PUNCT X
Amazon 's already large distribution empire keeps expanding URL813 #storystream #sports	PROPN AUX ADV ADJ PROPN PROPN VERB PROPN PROPN NOUN X
@USER1758 thanks I appreciate it	PROPN NOUN PRON VERB PRON
. @USER1407 @USER2135 Sera Community #Rhino Sanctuary Celebrate first Eastern Black Rhino birth URL247 @USER1516	PUNCT PROPN PROPN PROPN PROPN PROPN PROPN PROPN ADJ NOUN ADJ PROPN NOUN X X
RT @USER2211 : Hillary Clinton dresses like she 's in charge of some sort of space federation . URL1205	X X PUNCT PROPN PROPN NOUN SCONJ PRON AUX ADP VERB ADP DET NOUN ADP NOUN PROPN PUNCT X
@USER2623 you probly just deleted them all lmfao	VERB PRON VERB ADV VERB PRON DET INTJ
RT @USER845 : you know you made the wrong decision when marine le pen agrees URL1314	X X PUNCT PRON VERB PRON VERB DET ADJ NOUN ADV ADJ PROPN PROPN VERB NOUN
@USER1817 I love it ;)	PROPN PRON VERB PRON SYM
Stanley Cup Final Takeaways : Penguins top Sharks in thrilling Game 1 URL1393 penguinswinscf1.jpg … URL641	PROPN PROPN PROPN NOUN PUNCT PROPN NOUN NOUN ADP ADJ NOUN NUM PROPN X PUNCT X
2 people followed me // automatically checked by URL936	NUM NOUN VERB PRON SYM ADV VERB ADP PROPN
RT @USER1545 : This is gon na be my child URL1471	X X PUNCT PRON AUX VERB PART AUX PRON NOUN SYM
RT @USER1869 : Bulgaria 's president talks to euronews about free movement , migrants & border fences URL561 URL393 …	X X PUNCT PROPN PART ADJ NOUN PART VERB ADP ADJ NOUN PUNCT PROPN CCONJ NOUN PROPN PROPN X PUNCT
" If I play dead , he 'll go away "	PUNCT SCONJ PRON VERB ADJ PUNCT PRON AUX VERB ADV PUNCT
@USER1188 Such a nice guy right ?	PROPN VERB DET ADJ NOUN ADV PUNCT
RT @USER122 : We ’re not dating , but you ’re still mine .	X X PUNCT PRON AUX PART VERB PUNCT CCONJ PRON AUX ADV PRON PUNCT
RT @USER744 : Kelsea performing in Chicago ! [ 2.4.16 ] ( @USER164 ) URL399	X X PUNCT VERB NOUN ADP PROPN PUNCT PUNCT PROPN PUNCT PUNCT PROPN PUNCT X
RT @USER2069 : Kangaroos hold off Bulldogs to maintain unbeaten start to AFL ... #EtihadStadium URL1093	X X PUNCT PROPN VERB ADP NOUN ADP PROPN PROPN VERB ADP PROPN PUNCT X NOUN
RT @USER1913 : when you find a boy that 's cute , texts back fast , buys you food , AND stays loyal af URL707	X X PUNCT ADV PRON VERB DET NOUN PRON AUX ADJ PUNCT VERB ADV ADJ PUNCT VERB PRON NOUN PUNCT CCONJ VERB VERB NOUN NOUN
Black Wig Brasil : URL914	ADJ PROPN PROPN PUNCT X
More Photos As Mercy Aigbe Celebrates Her Son ’s 6th Birthday . URL1369 via @USER2638	ADJ NOUN SCONJ PROPN PROPN VERB PRON NOUN PART ADJ NOUN PUNCT VERB ADP PROPN
RT @USER1209 : Ppl will try to expose what 's wrong with u because they ca n't handle what 's right about u .	X X PUNCT PROPN AUX VERB PART VERB PRON AUX ADJ ADP PRON SCONJ PRON AUX PART VERB PRON AUX ADJ ADP PRON PUNCT
RT @USER1422 : " So what does your Son do for a living ? " URL1016	X X PUNCT PUNCT ADV PRON VERB PRON NOUN VERB ADP DET NOUN PUNCT PUNCT SYM
RT @USER1465 : Scientists now accept that we can bring dinosaurs back into the world using bird DNA .	X X PUNCT PROPN ADV VERB SCONJ PRON AUX VERB NOUN ADV ADP DET NOUN VERB ADJ NOUN PUNCT
RT @USER2551 : " Excuse me , $ hillary , your baggage is over the limit . " #NotMeUs #FBImWithHer @USER2222 @USER149	X X PUNCT PUNCT VERB PRON PUNCT SYM PROPN PUNCT PRON NOUN AUX ADP DET NOUN PUNCT PUNCT PROPN PROPN NOUN X
Want to work at Kold Trans ? We 're #hiring in #Cheyenne , WY ! Click for details : URL1038 #trucker URL438	VERB PART VERB ADP PROPN PROPN PUNCT PRON AUX ADJ ADP PROPN PUNCT PROPN PUNCT VERB ADP NOUN PUNCT PROPN NOUN X
RT @USER1897 : park bom high note URL733	X X PUNCT PROPN PROPN ADJ NOUN SYM
RT @USER2133 : DrMSG @USER530 JI ALMIGHTY !! MSG #OneYearOfMSG	X X PUNCT PROPN PROPN PROPN PROPN PUNCT VERB SYM
goodnight twitter 😎	NOUN PROPN SYM
RT @USER1224 : MS : How New Treatment Combats The Disease URL1430	X X PUNCT PROPN PUNCT ADV ADJ NOUN VERB DET NOUN X
RT @USER1835 : RT @USER45 A SciFi author explains why science fiction matters . ▶ URL1595 URL429 #amr …	X X PUNCT VERB VERB DET NOUN NOUN VERB ADV ADJ PROPN VERB PUNCT PROPN PROPN PROPN X PUNCT
RT @USER1723 : Buy Brand Viagra 100 mg . Order Viagra at URL1618 Online Pharmacy !	X X PUNCT VERB ADV PROPN NUM NOUN PUNCT NOUN PROPN ADP PROPN ADJ NOUN PUNCT
FOR A SECOND I WAS LIKE " WHO 'S EMY " BUT THEN IT HIT ME	ADP DET NOUN PRON AUX ADJ PUNCT PRON AUX NOUN PUNCT CCONJ SCONJ PRON VERB PRON
to celebrate this remarkable day i will read a bunch of yaois thx	PART VERB DET NOUN NOUN PRON AUX VERB DET NOUN ADP PROPN X
RT @USER97 : Should I release this ? RT URL1497	X X PUNCT AUX PRON VERB PRON PUNCT X X
@USER1539 do n't say that about him 😩 he 's just young ..	PROPN AUX PART VERB PRON ADP PRON SYM PRON AUX ADV ADJ PUNCT
RT @USER1532 : Soccer is the best stress reliever .	X X PUNCT PROPN AUX DET ADJ VERB PROPN PUNCT
RT @USER1432 : If you 're gon na see Deadpool a 3rd time , let me know when and where . Not asking for me . For my twin brother , Donald . h …	X X PUNCT SCONJ PRON AUX VERB PART VERB VERB DET ADJ NOUN PUNCT VERB PRON VERB ADV CCONJ ADV PUNCT PART VERB ADP PRON PUNCT ADP PRON ADJ NOUN PUNCT PROPN PUNCT NOUN PUNCT
@USER1547 We ca n't guarantee you 'll get a new one every time you reboot the router and ONT . It may take some time . ^DDD	PROPN PRON AUX PART VERB PRON AUX VERB DET ADJ NOUN DET NOUN PRON VERB DET NOUN CCONJ NOUN PUNCT PRON AUX VERB DET NOUN PUNCT X
RT @USER2562 : Ca n't get enough of you baby	X X PUNCT AUX PART VERB ADJ ADP PRON NOUN
RT @USER2660 : I want to win @USER1865 's books giveaway ! #esthetichadidgiveaways P.S. Saved accounts are allowed ! 💗🌸🌺 URL885 …	X X PUNCT PRON VERB PART VERB PROPN PART ADJ NOUN PUNCT PROPN PROPN PROPN NOUN AUX PROPN PUNCT PROPN PROPN PUNCT
Man what a birthday	NOUN PRON DET NOUN
#movies The Best Summer Vacations in Movies : The Best Summer Vacations in Movies URL239 #celebs #celebrity	VERB DET ADJ NOUN NOUN ADP PROPN PUNCT DET ADJ NOUN NOUN ADP PROPN PROPN X X
#roma : Salmo - The Italian Way URL578	PROPN PUNCT PROPN PUNCT DET PROPN NOUN X
RT @USER1414 : I 'm dead lmao 😭😂😭😂😂😂😂 " @USER2557 : The woman you thought you married vs who you really married URL451 "	X X PUNCT PRON AUX ADJ INTJ PROPN PUNCT X PUNCT DET NOUN PRON VERB PRON ADJ SCONJ PRON PRON ADV ADJ NOUN PUNCT
HO MY GAWD URL1023	VERB PRON NOUN SYM
RT @USER360 : The statistics are staggering ... URL1534 #untj4270	X X PUNCT DET NOUN AUX NOUN PUNCT X X
I have cracked and opened up the bag of cool ranch doritos	PRON VERB ADJ CCONJ VERB ADP DET NOUN ADP ADJ NOUN X
RT @USER1637 : You are my definition of the word " love . " Thank you .. thank you , @USER2199 . I am so proud of you .. always ❤ URL895 …	X X PUNCT PRON AUX PRON NOUN ADP DET NOUN PUNCT NOUN PUNCT PUNCT VERB PRON PUNCT VERB PRON PUNCT PROPN PUNCT PRON AUX ADV ADJ ADP PRON PUNCT ADV ADJ NOUN PUNCT
RT @USER2057 : I thought it was fake sub 😂😂😂😂 URL648	X X PUNCT PRON VERB PRON AUX ADJ ADJ NOUN NOUN
RT @USER2578 : The fact that dogs respect ' no ' more than a lot of guys is really messed up .	X X PUNCT DET NOUN DET NOUN NOUN PUNCT PRON PUNCT ADJ SCONJ DET NOUN ADP NOUN AUX ADV VERB ADP PUNCT
RT @USER1131 : HEY ! NEW MUSIC VIDEO TOMORROW ! It 's to my song " Home Sweet Home " 3 pm EST / noon PST on URL307 URL223 …	X X PUNCT INTJ PUNCT ADJ NOUN NOUN NOUN PUNCT PRON AUX ADP PRON NOUN PUNCT NOUN ADJ NOUN PUNCT NUM NOUN NOUN PUNCT PROPN NOUN ADP PROPN X PUNCT
RT @USER934 : @USER2609 @USER1361 it 's very strange how they are bending over backwards to get rid of Jeremy Corbyn . He is a decent …	X X PUNCT PROPN VERB PRON AUX ADV ADJ ADV PRON AUX ADJ ADP NOUN PART VERB NOUN ADP PROPN PROPN PUNCT PRON AUX DET NOUN PUNCT
RT @USER2368 : " Studio Ohana " is today 's tee on URL724 ReTweet for a chance at a FREE TEE ! URL394	X X PUNCT PUNCT PROPN NOUN PUNCT AUX NOUN PART ADJ ADP PROPN NOUN ADP DET NOUN ADP DET ADJ NOUN PUNCT X
@USER700 incredible show ! Thank you for the photo 💕 URL1076	PROPN ADJ NOUN PUNCT VERB PRON ADP DET NOUN SYM X
You and your family have questions about #retirement . This free guide provides answers : URL525 URL508	PRON CCONJ PRON NOUN VERB NOUN ADP PROPN PUNCT PRON ADJ NOUN SYM X PUNCT X NOUN
Lawd knows I ai n't perfect but I sholl deserve it . Send somebody that wo n't turn they back on me .	PROPN VERB PRON AUX PART ADJ CCONJ PRON VERB VERB PRON PUNCT VERB PRON PRON AUX PART VERB PRON ADV ADP PRON PUNCT
@USER2355 Are you frustrated ?	PROPN AUX PRON VERB PUNCT
RT @USER462 : My kind of waffles URL1433	X X PUNCT PRON NOUN ADP PROPN X
Told You I can fly … URL351	PROPN PRON PRON AUX VERB PUNCT X
Why was I so excited about my broken arm URL580	ADV AUX PRON ADV VERB ADP PRON VERB NOUN SYM
RT @USER211 : FIRST LOOK : Virginia Madsen ( @USER2198 ) to guest star on #Elementary . Check - out via @USER392 : URL1356 URL222 …	X X PUNCT ADV NOUN PUNCT PROPN PROPN PUNCT PROPN PUNCT ADP NOUN NOUN ADP PROPN PUNCT VERB PUNCT ADP ADP PROPN PUNCT X X PUNCT
@USER667 It can be very frustrating at times . That 's why I almost never fully open up to people .	PROPN PRON AUX AUX ADJ ADJ ADP NOUN PUNCT PRON AUX ADV PRON ADV ADV VERB ADJ ADP ADP NOUN PUNCT
@USER2507 completely forgot about the NPA . We might have to renew our membership .	PROPN PROPN VERB ADP DET NOUN PUNCT PRON AUX VERB PART VERB PRON NOUN PUNCT
RT @USER2506 : powerful @USER1061 piece by Tim Duncan . URL812	X X PUNCT ADJ ADJ NOUN ADP PROPN PROPN PUNCT X
@USER208 @USER665 @USER1253 you find that many people actually agree with voluntarism , once they 're questioned on it , unless	PROPN PROPN VERB PRON VERB DET ADJ NOUN ADV VERB ADP PROPN PUNCT SCONJ PRON AUX VERB ADP PRON PUNCT ADV
RT @USER1081 : At it again ..... URL556	X X PUNCT SCONJ PRON ADV PUNCT X
RT @USER326 : . @USER863 owns this Big L painting . It 's " The Big Picture " cover . Instead of making a gun , L gives the thumbs up . URL0 …	X X PUNCT PUNCT VERB VERB DET ADJ ADJ NOUN PUNCT PRON AUX PUNCT DET ADJ NOUN PUNCT NOUN PUNCT ADV SCONJ VERB DET NOUN PUNCT VERB VERB DET NOUN ADP PUNCT X PUNCT
GD also worked with kush so why not iKON ? Ugly af 💀💀💀 URL470	PROPN ADV VERB ADP PROPN ADV ADV PART VERB PUNCT ADJ NOUN NOUN X
She Called 911 When Her 22 - Week - Old Baby Had Been Born Just One Day After An Abortion URL653	PRON VERB VERB ADV VERB NOUN PUNCT NOUN PUNCT PROPN PROPN PROPN PROPN NOUN ADV NUM NOUN ADP DET NOUN X
RT @USER13 : OG 's aint chilling 😂 URL680	X X PUNCT PROPN AUX AUX ADJ SYM X
Microsoft Xbox 360 60 GB White Console w/ Controller and 512 mb Memory Card - Bid Now ! Only … URL884 URL1316	PROPN PROPN PROPN NUM NOUN ADJ NOUN ADP PROPN CCONJ PROPN NOUN PROPN NOUN PUNCT VERB ADV PUNCT ADV PUNCT X X
‘ A time bomb waiting to explode ’ – Survey reveals GPs ’ concerns about mental health services for young people #teens #health	PUNCT DET NOUN NOUN VERB ADP PROPN PUNCT PUNCT NOUN PROPN PROPN PUNCT VERB ADP PROPN NOUN NOUN ADP ADJ NOUN NOUN X
RT @USER422 : What the ...... URL761	X X PUNCT PRON DET NOUN NOUN
RT @USER33 : 5000 #TheNextGalaxy retweets in 30 mins unlock the box ! RT & you stand a chance to WIN R30000 with @USER1173 URL1564 …	X X PUNCT PROPN NOUN NOUN ADP NUM NOUN VERB DET NOUN PUNCT VERB CCONJ PRON VERB DET NOUN PART VERB VERB ADP PROPN X PUNCT
Let 's take a cruise 🌀 URL243	VERB PART VERB DET NOUN NOUN X
RT @USER2415 : Asaram BapuJi - ' Parenthood is beyond castes & religions . Respect ur parents ! ' #LovedParentsWorshipDay URL777	X X PUNCT PROPN NOUN PUNCT PUNCT PROPN AUX ADP NOUN CCONJ NOUN PUNCT NOUN PRON NOUN PUNCT PUNCT PROPN NOUN
#NowPlaying Shawn Mendes Camila Cabello - I Know What You Did Last Summer :: Tune In : URL780	X PROPN PROPN PROPN NOUN PUNCT PRON VERB PRON PRON VERB ADJ NOUN NOUN VERB ADP PUNCT X
@USER253 Oxygen ...... I need oxygen . I 'm laughing so hard on forgot to breath 😂😂😂😂😂😂😂😂😂😂😂😂😂😂😂😂😂😂😂😂😂😂😂😂😂😂😂😂😂😂😂😂😂😂😂😂😂😂😂😂	PROPN PROPN PROPN PRON VERB PROPN PUNCT PRON AUX VERB ADV ADJ ADP NOUN ADP NOUN NOUN
RT @USER749 : This is the # 1 tip sheet for dealing with stress : URL1204 URL806	X X PUNCT PRON AUX DET NOUN NUM NOUN NOUN ADP NOUN ADP PROPN PUNCT PROPN X
Yes RT @USER2261 : Honest opinion do I come off as a nigga with multiple women ?	INTJ X X PUNCT PROPN NOUN AUX PRON VERB ADP ADP DET NOUN ADP PROPN NOUN PUNCT
@USER730 @USER1279 @USER2031 want to dota ?	PROPN PROPN NOUN VERB ADP PROPN PUNCT
RT @USER630 : The first picture is Chicago at 2:30 on April 2 , 2016 The second picture is Chicago at 2:40 April 2 , 2016 🌞🌚 URL223 …	X X PUNCT DET ADJ NOUN AUX PROPN ADP PROPN ADP PROPN NUM PUNCT NUM DET ADJ NOUN AUX PROPN ADP PROPN PROPN NUM PUNCT NUM PROPN X PUNCT
RT @USER284 : I imagine feminists are gon na be insufferable about it .	X X PUNCT PRON VERB PROPN AUX VERB PART AUX ADJ ADP PRON PUNCT
RT @USER1625 : 13 . " why do n't i have a penis " I CANTRS BREATHE URL570	X X PUNCT X PUNCT PUNCT ADV AUX PART PRON VERB DET NOUN PUNCT PRON VERB ADJ NOUN
Lmao these dudes are at mcgolf URL1280	INTJ DET NOUN AUX ADP PROPN NOUN
6 reasons you need to buy auto insurance URL671	NUM NOUN PRON VERB PART VERB NOUN NOUN X
RT @USER1384 : Groupme emojis way more lit than the regular iOS emojis 😞	X X PUNCT PROPN VERB NOUN ADV VERB ADP DET NOUN PROPN X SYM
RT @USER1839 : I need to fall In Love with a New Rap song . It s been long	X X PUNCT PRON VERB PART VERB SCONJ VERB ADP DET ADJ NOUN NOUN PUNCT PRON AUX AUX ADJ
Arab & Iranian Leaders Who Are Mostly Muslims & Read The Quran MUST Become Role Models For Promoting The Unity of The Human Family .	PROPN CCONJ PROPN VERB PRON AUX ADJ NOUN CCONJ VERB DET NOUN PROPN PROPN NOUN NOUN SCONJ VERB DET NOUN ADP DET ADJ NOUN PUNCT
Wan na have a deep conversation	VERB PART VERB DET ADJ NOUN
@USER316 @USER1030 the UK that existed then does n't exist now . Next !	PROPN VERB DET PROPN PRON VERB ADV AUX PART VERB ADV PUNCT ADJ PUNCT
RT @USER1616 : electric forest 🌲	X X PUNCT PROPN NOUN X
@USER1505 loved it ... thank you so much	PROPN ADJ PRON PUNCT VERB PRON ADV ADV
Found a Transponder Snail ! Giants , sea monsters and other amazing encounters ! URL1483 #TreCru URL259	VERB DET ADJ NOUN PUNCT PROPN PUNCT NOUN NOUN CCONJ ADJ ADJ NOUN PUNCT VERB X X
Another day to be productive 💪🏾 #LetsGetIt 👊🏾	DET NOUN PART AUX ADJ PROPN NOUN X
@USER2014 of @USER1220 a HAPPY 28th BIRTHDAY ! #NBABDAY URL909	VERB ADP VERB DET ADJ PROPN PROPN PUNCT X X
@USER1712 @USER1362 I 'm already dead	PROPN PROPN PRON AUX ADV ADJ
When you 're happy , you enjoy the music and when you 're sad , you understand the lyrics . #markisanation	ADV PRON AUX ADJ PUNCT PRON VERB DET NOUN CCONJ ADV PRON AUX ADJ PUNCT PRON VERB DET NOUN PUNCT X
RT @USER1627 : I 'm tryna get in a healthy relationship , shit 😂😂 URL231	X X PUNCT PRON AUX VERB VERB ADP DET ADJ NOUN PUNCT NOUN SYM X
Hello @USER174 , thank you for partnering with us . We are always delighted to serve you . Do have a great day .	INTJ PROPN PUNCT VERB PRON ADP ADJ ADP PRON PUNCT PRON AUX ADV ADJ PART VERB PRON PUNCT AUX VERB DET ADJ NOUN PUNCT
Cant wait . 🙈💃 Temme your gang is winning right ? 😥 Haina ? 😋 URL631	PROPN VERB PUNCT PROPN VERB PRON NOUN AUX VERB ADV PUNCT PROPN PROPN PUNCT X X
#CinObservatory #OHWX : Temp : -0.28 °C , Hum : 68 % , Bar : mb , UV : 1/1600 , As of : April 10 , 2016 at 12:04 AM	PROPN PROPN PUNCT PROPN PUNCT PROPN NOUN PUNCT PROPN PUNCT PROPN SYM PUNCT PROPN PUNCT NOUN PUNCT PROPN PUNCT PROPN PUNCT ADV ADP PUNCT PROPN NUM PUNCT NUM ADP PROPN NOUN
@USER1605 Bracelet in right hand is missing Piercing on chin is missing #SpotTheMissing .	PROPN NOUN ADP ADJ NOUN AUX ADJ NOUN ADP PROPN AUX ADJ NOUN PUNCT
Fuck today . Fuck Imogen . Fuck all of it !	PROPN NOUN PUNCT VERB PROPN PUNCT VERB DET ADP PRON PUNCT
RT @USER522 : “ It ’s a red flag ” — Polar bears are losing weight as #Arctic sea ice melts . URL526 #SaveTheArctic URL221 …	X X PUNCT PUNCT PRON AUX DET ADJ NOUN PUNCT PUNCT PROPN NOUN AUX VERB NOUN ADP PROPN NOUN PROPN NOUN PUNCT PROPN X X PUNCT
@USER1003 ok lol also I have never been awake at 5 in years lol earliest I get up at is 8 in the morning lol	PROPN PROPN INTJ ADV PRON VERB ADV AUX ADJ ADP NUM ADP NOUN INTJ SCONJ PRON VERB ADP ADV AUX NUM ADP DET NOUN INTJ
[ OnlyPiolou ] is available since 2 minute ( s ) ! ( 2016-03-19 11:38:49 ) ( UTC+01:00 ) - #minecraft	PUNCT PROPN PUNCT AUX VERB ADP NUM NOUN PUNCT ADJ PUNCT PUNCT PUNCT PROPN PROPN PUNCT PUNCT PROPN PUNCT PUNCT PROPN
RT @USER1337 : Classic 😁 URL1443	X X PUNCT ADJ NOUN NOUN
RT @USER648 : @USER2067 @USER790 @USER661 @USER1148 @USER1751 means ya get to start drinking whenever ya want	X X PUNCT PROPN PROPN PROPN PROPN NOUN VERB PRON VERB PART VERB PROPN ADV PRON VERB
Votes from thepeoplepick what person isthe next sittingpresident . " WHO PICKS " THEPEOPLE THAT WILLBETHE PERSONS WE VOTE FOR2BE NEXT PRESIDENT . ?	VERB ADP VERB PRON NOUN PROPN ADJ NOUN PUNCT PUNCT PRON VERB PUNCT VERB DET NOUN VERB PRON VERB PROPN PROPN NOUN PUNCT PUNCT
SOON : We reveal the secret signals your body 's giving off without you even knowing ... #TMS7	PROPN PUNCT PRON VERB DET NOUN VERB PRON NOUN PART VERB ADP ADP PRON ADV PROPN PUNCT X
Just posted a photo @ La Provence Lake Oswego URL237	ADV VERB DET NOUN ADP PROPN PROPN PROPN X X
Why the Stakes Are So High in Today ’s Rivers Election URL1634	ADV DET NOUN AUX ADV ADJ ADP NOUN PART PROPN NOUN SYM
RT @USER838 : I want to be with you . Everyday .	X X PUNCT PRON VERB PART AUX ADP PRON PUNCT PROPN PUNCT
RT @USER129 : I , a large wrinkle , have made these smaller wrinkles . URL1067	X X PUNCT PRON PUNCT DET NOUN NOUN PUNCT AUX VERB DET ADJ NOUN PUNCT X
You prefer to keep the peace but you might feel called to spea ... More for Libra URL1015	PRON VERB PART VERB DET NOUN CCONJ PRON AUX VERB VERB ADP PROPN PUNCT ADJ ADP PROPN X
HAHAHAHAH OMG KHLOE IF YOU WANT TO DRAG SOMEONE PLEASE DONT END UP BEING EMBARRASSING	PROPN INTJ VERB SCONJ PRON VERB PART PROPN PROPN INTJ PROPN NOUN ADP NOUN X
RT @USER28 : On October 7 • Fifth Harmony will perform at the Manchester Arena Capacity : 21,000 People #727Tour URL736	X X PUNCT ADP PROPN NUM PROPN PROPN PROPN AUX VERB ADP DET PROPN PROPN X PUNCT PROPN NOUN NOUN X
Till I loved , I never lived -- enough . - Emily Dickinson	PROPN PRON ADJ PUNCT PRON ADV VERB PUNCT ADJ PUNCT PUNCT PROPN X
@USER879 last time I checked . July 22nd is in fact in summer ???	PROPN ADJ NOUN PRON VERB PUNCT PROPN PROPN AUX ADP NOUN ADP NOUN PUNCT
RT @USER1552 : This Man 's Blackheads Were Popped Out , See The Shocking Transformation After URL1248 URL492 …	X X PUNCT DET NOUN PART ADJ PROPN VERB ADV PUNCT VERB DET NOUN NOUN ADP PROPN X PUNCT
ayerene - @USER1654 - babe - zayn -spongeboobs - pretty af - ia bc school ily 😽	PROPN PUNCT PROPN PUNCT PROPN PUNCT PROPN PROPN PUNCT ADV NOUN PUNCT PROPN ADP NOUN VERB SYM
RT @USER1621 : As Assad destroys much of health system , Syrians die as often of chronic disease as bullets . URL1082 htt …	X X PUNCT SCONJ VERB PROPN ADJ ADP NOUN NOUN PUNCT PROPN VERB ADP ADV ADP PROPN NOUN ADP PROPN PUNCT X X PUNCT
@USER198 thanks for getting back to me so quickly .	ADJ NOUN SCONJ VERB ADV ADP PRON ADV PROPN PUNCT
Morning lovelies ✨ hope you have a wonderful day 💐 xxx URL1462	PROPN PROPN SYM VERB PRON VERB DET ADJ NOUN NOUN SYM X
RT @USER1996 : Team B - Climax 140413 , YG Family Power 2014 Tour in Japan Junhoe singing with a pistachio stuck in his throat ! 😱😉 URL218 …	X X PUNCT NOUN NOUN PUNCT PROPN PROPN PUNCT PROPN NOUN PROPN ADJ NOUN ADP PROPN PROPN VERB ADP DET NOUN VERB ADP PRON NOUN PUNCT X X PUNCT
RT @USER2560 : #EURO2016 Group F FT #POR 0-0 #AUT URL792	X X PUNCT X PROPN PROPN PROPN PROPN PROPN NOUN X
RT @USER1752 : hair color by your 's truly URL364	X X PUNCT NOUN NOUN ADP PRON AUX ADV SYM
@USER111 #Prophecy of #StrictlyBidness on #ReverbNation #HitPlay URL1132	PROPN NOUN ADP NOUN ADP PROPN PROPN X
Turkey 's Erdogan pours cold water on hopes of progress on EU deal URL571 via @USER1123	PROPN AUX VERB ADJ NOUN NOUN ADP NOUN ADP NOUN ADP PROPN PROPN X ADP PROPN
RT @USER2000 : Mother - daughter relationship like Atita Haris & her daughter please ! 😍😍😍 URL1053	X X PUNCT PROPN PUNCT PROPN NOUN ADP PROPN NOUN CCONJ PRON NOUN INTJ PUNCT SYM X
RT @USER2320 : * opens Snapchat * " so today I was .... " " I just hate when .. " " lem me tell y'all what just happe .... " " my boyfriend .. " URL218 …	X X PUNCT PUNCT PROPN PROPN PUNCT PUNCT ADV NOUN PRON AUX PUNCT PUNCT PUNCT PRON ADV VERB ADV PUNCT PUNCT PUNCT VERB PRON VERB PRON PRON ADV PROPN PUNCT PUNCT PUNCT PRON NOUN PUNCT PUNCT X PUNCT
#PromoProduct Need Something For the Office ? Choose Branded Merchandise As Corporate Gifts URL1126	PROPN VERB VERB ADP DET NOUN PUNCT VERB ADJ NOUN SCONJ PROPN X X
LIMITED EDITION half nudes	PROPN PROPN NOUN NOUN
@USER858 block 2C	PROPN PROPN NOUN
LloydsPharmacy : Pharmacist - Attleborough #Pharmacy URL1162	PROPN PUNCT PROPN PUNCT PROPN PROPN X
Whatever song @USER1393 just made me listen to by ariana grande completely snatched me I 'm changed	PROPN NOUN NOUN ADV VERB PRON VERB ADP ADP PROPN PROPN PROPN VERB PRON PRON AUX VERB
RT @USER22 : RT & REPLY ! #iHeartAwards #BestFanArmy #5SOSFam URL261	X X PUNCT VERB CCONJ VERB PUNCT X X X X
Sooooo good to find the London #culinary scene is still as #awesome as ever thank you @USER818 #raresteak URL952	PROPN ADJ PART VERB DET PROPN PROPN NOUN AUX ADV SCONJ NOUN SCONJ ADV VERB PRON VERB NOUN NOUN
Helping You Get A Better Understanding About Employment With Simple Tips URL1051	PROPN PRON VERB DET ADJ NOUN ADJ NOUN ADP PROPN NOUN X
#porn #porn Swipe Hookup - meet sexy ladies for SEX DATING - visit : URL553 URL697	PROPN PROPN PROPN PROPN PUNCT VERB ADJ NOUN ADP PROPN PROPN PUNCT PROPN PUNCT X NOUN
Want to bang me ? URL1254 #ass #butt #orgies #sexygifs URL245	VERB PART VERB PRON PUNCT PROPN PROPN PROPN NOUN NOUN X
best thing ever is definitely when people read your message and do n't reply	ADJ NOUN ADV AUX ADV ADV NOUN VERB PRON NOUN CCONJ AUX PART VERB
👌💃 ( with family at Mie Alfin Pengayoman ) — URL1300	PROPN PUNCT ADP NOUN ADP PROPN PROPN PROPN PUNCT PUNCT X
RT @USER990 : @USER1815 and yet u chose to make the unarmed victim look like a criminal in this case .. 🤔	X X PUNCT VERB CCONJ VERB PRON VERB PART VERB DET NOUN NOUN VERB SCONJ DET NOUN ADP DET NOUN PUNCT SYM
I stay getting mad at old shit I need to stop 😭	PRON VERB VERB ADJ ADP ADJ NOUN PRON VERB PART VERB SYM
RT @USER2007 : Your heart beats about 100,00 times in one day and 36.5 million times in a year .	X X PUNCT PRON NOUN NOUN ADP ADJ NOUN ADP NUM NOUN CCONJ VERB NUM NOUN ADP DET NOUN PUNCT
RT @USER311 : Lovable AND Quick Do it yourself VALENTINE 'S Working day Presents | THE SORRY Girls - URL1459	X X PUNCT PROPN CCONJ NOUN VERB PRON PRON NOUN PART VERB NOUN PROPN SYM DET ADJ NOUN PUNCT X
well it s a dream job for many , some in the testing section haha URL694	INTJ PRON AUX DET NOUN NOUN ADP ADJ PUNCT DET ADP DET NOUN PROPN INTJ VERB
I hate not getting my way and I hate being told no but I m never told no and I always get my way so I have no complaints 😂	PRON VERB PART VERB PRON NOUN CCONJ PRON VERB AUX VERB DET CCONJ PRON AUX ADV VERB DET CCONJ PRON ADV VERB PRON NOUN ADV PRON VERB DET NOUN SYM
RT @USER1515 : I needa stop sleeping thru like half the day BC I always end up being up all night 🙃	X X PUNCT PRON VERB VERB VERB NOUN ADP NOUN DET NOUN SCONJ PRON ADV VERB ADV AUX ADP DET NOUN SYM
RT @USER2023 : try this class out let me know what you think URL1547	X X PUNCT VERB DET NOUN ADV VERB PRON VERB PRON PRON VERB SYM
RT @USER1520 : Mitch to Raul - I think Nikki ca nt win but Tim can . I think he says he does nt want to win but he does #BBCAN4	X X PUNCT VERB ADP PROPN PUNCT PRON VERB PROPN AUX PART VERB CCONJ NOUN AUX PUNCT PRON VERB PRON VERB PRON AUX PART VERB PART VERB CCONJ PRON VERB ADJ
RT @USER327 : Type of girl I want 🙌🏼 URL365	X X PUNCT VERB ADP NOUN PRON VERB ADJ SYM
Pain is just a consequence of love	PROPN AUX ADV DET NOUN ADP NOUN
@USER2500 w me in background	VERB ADP PRON ADP PROPN
@USER1040 cool dude you are 😎	PROPN ADJ NOUN PRON AUX SYM
RT @USER1864 : Beautiful California Flower Fields You Must Visit This Spring ► URL337 @USER1336 #SanDiego URL218 …	X X PUNCT ADJ PROPN PROPN PROPN PRON AUX VERB DET NOUN PROPN PROPN X X X PUNCT
How to fill baseball 's biggest roster holes : Dozens of free agents remain unsigned , including many household n ... URL1602	ADV ADP PROPN PROPN PART ADJ ADJ NOUN PUNCT VERB ADP ADJ NOUN PROPN PROPN PUNCT PROPN ADJ NOUN CCONJ PUNCT X
RT @USER1811 : iTunes US : 64 ( + 2 ) Demi Lovato - Body Say ! Buy or gift here : URL1593	X X PUNCT PROPN PROPN PUNCT PROPN PUNCT SYM NUM PUNCT PROPN PROPN PUNCT PROPN VERB PUNCT VERB CCONJ VERB ADV PUNCT X
Donald Trump Reads The Snake Lyric At Campaign Rally Referring To Immigr ... URL295 via @USER1490	PROPN PROPN VERB DET NOUN NOUN ADV ADJ NOUN NOUN ADP NOUN PUNCT VERB ADP PROPN
RT @USER1980 : Curse on Such TABDEELi And New Pakistan in which Women being Molested , Harassed by their own Hooligans !!! #PTIwomenMolesters	X X PUNCT NOUN ADP PROPN NOUN CCONJ ADJ NOUN ADP DET NOUN AUX NOUN PUNCT VERB ADP PRON ADJ NOUN PUNCT X
RT @USER2312 : Maybe If I Was Harry Styles I Could Swim Across The Atlantic .	X X PUNCT VERB SCONJ PRON VERB PROPN PROPN PRON AUX VERB NOUN DET NOUN PUNCT
LIVE on #Periscope : YoungBankRoll URL1563	ADJ ADP PROPN PUNCT PROPN NOUN
RT @USER1764 : they just Used winwin	X X PUNCT PRON ADV VERB X
RT @USER2213 : WMUR reporting that Cruz will announce intention to name Fiorina running mate .	X X PUNCT PROPN VERB PRON PROPN AUX VERB NOUN PART VERB PROPN VERB NOUN PUNCT
RT @USER1347 : 10 Thousand Times Faster Swift URL1075	X X PUNCT NUM NUM PROPN PROPN PROPN X
Peter Capaldi Confirms New Doctor Who Companion Has Been Cast : Current Doctor Who Peter Capaldi … URL857 #drwho #doctorwho	PROPN PROPN PROPN ADJ PROPN PRON VERB VERB ADJ NOUN PUNCT PROPN VERB PRON VERB X PUNCT PROPN NOUN X
You can get carried away with your desire to retreat from the ... More for Aries URL531	PRON AUX VERB VERB ADV ADP PRON NOUN PART VERB ADP DET PUNCT ADJ ADP NOUN X
@USER1431 btw , are you Hispanic ? I 've been meaning to ask !	PROPN ADV PUNCT AUX PRON VERB PUNCT PRON AUX AUX ADJ PART VERB PUNCT
RT @USER2631 : Wrong number texted me today URL374	X X PUNCT PROPN NOUN VERB PRON NOUN X
RT @USER382 : Ted Cruz promised people of Texas he 'd lead fight against Obamacare , exploding debt , cronyism & amnesty . Ted Cruz promised , t …	X X PUNCT PROPN PROPN PROPN NOUN ADP PROPN PRON AUX VERB NOUN ADP PROPN PUNCT PROPN PROPN PUNCT NOUN CCONJ NOUN PUNCT PROPN PROPN PROPN PUNCT X PUNCT
New goal : become an Olympic pup ! URL1019	ADJ NOUN PUNCT VERB DET NOUN NOUN PUNCT X
RT @USER740 : Donovan Mitchell 's athletic ability is unreal .	X X PUNCT PROPN PROPN PART ADJ NOUN AUX PROPN PUNCT
RT @USER2297 : The only straight I am is a straight up bitch	X X PUNCT DET ADJ ADV PRON AUX AUX DET ADJ ADP NOUN
I miss him 😔💙	PRON VERB PRON SYM
RT @USER504 : Tfry wild af 😂	X X PUNCT PROPN NOUN NOUN SYM
RT @USER1418 : Yeah getting buckets is important but so is stopping someone from getting them is too . URL722	X X PUNCT INTJ AUX NOUN AUX ADJ CCONJ ADV AUX VERB PRON SCONJ VERB PRON AUX ADV PUNCT X
RT @USER800 : Gone Viral ! This Mum & 1 Day Old Baby Sea Otter Cuddling Are A Cuteness Overload ! - CLICK --> >>> URL447 URL218 …	X X PUNCT PROPN NOUN PUNCT PRON NOUN CCONJ NUM NOUN PROPN PROPN PROPN X NOUN AUX DET ADJ NOUN PUNCT PUNCT PROPN SYM PROPN X X PUNCT
@USER54 thanks for sharing ---==AdamCSmith==--- , have a great Friday :) ( Want this FREE ? >> URL391 )	PROPN NOUN ADP PROPN PROPN PUNCT VERB DET ADJ PROPN SYM PUNCT VERB DET ADJ PUNCT PUNCT PROPN PUNCT
RT @USER631 : Most slept on artists of today 23 . ) Joey Purp URL1159	X X PUNCT ADJ NOUN ADP NOUN ADP NOUN NUM PUNCT PUNCT PROPN NOUN X
RT @USER95 : Dear Leaders of the Opposition ! Do nt let Your dislike for PM @USER2286 translate into your support for people who want …	X X PUNCT NOUN NOUN ADP DET NOUN PUNCT AUX PART VERB PRON NOUN ADP NOUN NOUN NOUN ADP PRON NOUN ADP NOUN PRON VERB PUNCT
How TO Get Over Your Ex Fast - URL1395 URL1513	ADV PART VERB ADP PRON SYM PROPN PUNCT PROPN X
Dierks Bentley Is Having Naked Nightmares About Hosting the ACM Awards - and Everyone Benefits ! URL618	PROPN PROPN AUX ADJ PROPN NOUN SCONJ NOUN DET NOUN NOUN PUNCT CCONJ PROPN NOUN PUNCT X
Mad men is got to be the best show of all time . Up there with the greats ( i.e. Sopranos ) if not the ultimate best .	PROPN NOUN AUX VERB PART AUX DET ADJ NOUN ADP DET NOUN PUNCT ADP PRON ADP DET NOUN PUNCT PROPN NOUN PUNCT SCONJ PART DET ADJ ADJ PUNCT
Hot Video ! ' In bed with Kanye ' : Sophie Monk parodies rapper 's ... URL428	ADJ NOUN PUNCT VERB ADP NOUN ADP PROPN PUNCT PUNCT PROPN PROPN PROPN NOUN PART PUNCT X
Planning a heist at Game to get a copy of No Man 's Sky instead of waiting a week . I know they have it .	VERB DET NOUN ADP NOUN PART VERB DET NOUN ADP DET NOUN PART VERB ADV SCONJ VERB DET NOUN PUNCT PRON VERB PRON VERB PRON PUNCT
Hello from the other side I must 've called a thousand times @USER2316	INTJ ADP DET ADJ NOUN PRON AUX AUX VERB DET NOUN NOUN NOUN
RT @USER988 : VIDEO : The @USER584 staged a live sit - in to address gun control measures and gun violence URL869 #NoB …	X X PUNCT X PUNCT DET NOUN VERB DET ADJ NOUN PUNCT ADP ADP NOUN PROPN PROPN NOUN CCONJ PROPN NOUN PROPN NOUN PUNCT
am i the only one that does n’t do anything the whole day but gets depressed when the day ends and sees they did n’t do anything	AUX PRON DET ADJ NOUN PRON AUX PART VERB PRON DET ADJ NOUN CCONJ VERB VERB ADV DET NOUN NOUN CCONJ VERB PRON AUX PART VERB PRON
A new territory is discovered in The Tribez & Castlez ! Can you unlock it too ? URL965 #android , #androidgames , #gameinsight	DET ADJ NOUN AUX ADJ ADP DET NOUN CCONJ NOUN PUNCT AUX PRON VERB PRON ADV PUNCT PROPN PROPN PUNCT PROPN PUNCT SYM
@USER2328 I love you in the purest sense	PROPN PRON VERB PRON ADP DET NOUN NOUN
@USER457 A1 ) 1 . Ninja Turtles 2 . Iron Man 3 . Captain America 4 . Patrick 5 . Darth Vader 6 . Spongebob #FlipkartCuriousCases	PROPN NUM PUNCT NUM PUNCT PROPN PROPN NUM PUNCT NOUN NOUN NUM PUNCT PROPN PROPN NUM PUNCT PROPN NUM PUNCT PROPN ADJ NUM PUNCT X X
RT @USER1901 : fucking endless women you do n't care about is n't gon na change the fact that you still love your ex girlfriend my nigga . …	X X PUNCT ADV ADJ NOUN PRON AUX PART VERB SCONJ AUX PART VERB PART VERB DET NOUN SCONJ PRON ADV VERB PRON NOUN NOUN PRON NOUN PUNCT PUNCT
181 Death and All His Friends #VeranoMTV2016 Coldplay #MTVHottest Coldplay	PROPN NOUN CCONJ DET PRON ADJ X PROPN PROPN X
* Tips To Get A Girlfriend Without Spending Too Much Money >> URL557	PUNCT NOUN PART VERB DET NOUN SCONJ VERB ADV ADJ NOUN PUNCT X
RT @USER298 : Highest quality tea tree oil on the market . #beauty #health #skincare #teatreeoil URL158 URL137 …	X X PUNCT PROPN ADJ NOUN NOUN NOUN ADP DET NOUN PUNCT PROPN PROPN PROPN PROPN X X PUNCT
Hey , @USER2366 , let 's go on a #DateNight to see @USER1892 . 💑😂 . I see lots of belly laughs in our future !!! 🔮 URL1434	INTJ PUNCT PROPN PUNCT VERB PART VERB ADP DET NOUN PART VERB PROPN PUNCT PROPN PUNCT PRON VERB NOUN ADP NOUN NOUN ADP PRON NOUN PUNCT X X
RT @USER1293 : Glaswegian burds say there 's nuhin sexier than the sound ae a boy rippin aff his velcro trainers	X X PUNCT PROPN NOUN VERB PRON AUX ADJ VERB ADP DET NOUN VERB DET NOUN NOUN VERB PRON NOUN X
Haters gon na hate	NOUN VERB PART VERB
@USER1645 you 've changed a lot jkjk	PROPN PRON AUX VERB DET NOUN NOUN
RT @USER2191 : This Rare Picture Captures Something That Happens In Less Than 1 Out Of 80,000 Births URL1010	X X PUNCT DET NOUN PROPN NOUN VERB PRON NOUN ADP NOUN NOUN NUM ADP ADP PROPN PROPN X
RT @USER1204 : Today is a big day if you are hoping to become a wealthy venture capitalist URL1505 h/t @USER621 URL220 …	X X PUNCT NOUN AUX DET ADJ NOUN SCONJ PRON AUX VERB PART VERB DET NOUN NOUN PROPN PROPN X X X PUNCT
RT @USER918 : It 's still 🍀🍀🍀🍀🍀 all day	X X PUNCT PRON AUX ADV VERB DET NOUN
@USER112 please follow me !!	PROPN INTJ VERB PRON PUNCT
RT @USER2423 : every time a white person meets a Muslim at a grocery store they write a dramatic Facebook post about it lol URL1633 …	X X PUNCT DET NOUN DET ADJ NOUN VERB DET NOUN ADP DET NOUN NOUN PRON VERB DET ADJ PROPN VERB ADP PRON INTJ X PUNCT
RT @USER2292 : 😂😂😂😂😂 ladies are enjoying this #SAMenBreakTheInternet	X X PUNCT SYM NOUN AUX VERB PRON NOUN
Here just swingin URL987	ADV ADV VERB SYM
RT @USER2531 : 10 . When Rihanna was getting LIT to her own song while getting a manicure , she was really feeling herself . 😍😜 URL224 …	X X PUNCT NUM PUNCT ADV PROPN AUX AUX ADJ ADP PRON ADJ NOUN SCONJ VERB DET NOUN PUNCT PRON AUX ADV VERB PRON PUNCT X X PUNCT
Thanks @USER2372 for the follow ! I really appreciate it ! Looking forward to learning more about you and what you do :-)	NOUN NOUN ADP DET NOUN PUNCT PRON ADV VERB PRON PUNCT VERB ADV PART VERB ADJ ADP PRON CCONJ PRON PRON VERB SYM
hell naw ... maybe after spring break URL346	NOUN INTJ PUNCT ADV ADP PROPN NOUN X
Looking for a new epilator ? Philips Satin Soft Wet & Dry Epilator now £ 30 ( WAS £ 100 ) from our OFFICIAL @USER1845 shop URL941	VERB ADP DET ADJ NOUN PUNCT VERB PROPN NOUN NOUN CCONJ VERB NOUN ADV SYM NUM PUNCT NUM SYM NUM PUNCT ADP PRON NOUN NOUN NOUN X
These guys are just so full of themselves , saying such things . " Great gesture and confidence booster " , apparently . URL384	DET NOUN AUX ADV ADV ADJ ADP PRON PUNCT VERB ADJ NOUN PUNCT PUNCT ADJ NOUN CCONJ ADJ NOUN PUNCT PUNCT PROPN PUNCT X
RT @USER627 : I 'm the most jealous person on the planet . what 's mine is mine , do n't look at it , do n't touch , and do n't even think ab …	X X PUNCT PRON AUX DET ADJ ADJ NOUN ADP DET NOUN PUNCT PRON AUX PRON AUX PRON PUNCT AUX PART VERB ADP PRON PUNCT AUX PART NOUN PUNCT CCONJ AUX PART ADV VERB PROPN PUNCT
RT @USER2022 : how I 'm gunna be when I have a family URL1545	X X PUNCT ADV PRON AUX ADJ AUX ADV PRON VERB DET NOUN NOUN
RT @USER1518 : Do n't talk bad about the person when things go south bc at one point in time that 's exactly what you wanted .	X X PUNCT AUX PART VERB ADJ ADP DET NOUN ADV NOUN VERB VERB ADP ADP NUM NOUN ADP NOUN PRON AUX ADV PRON PRON VERB PUNCT
Ray Wilkins urges Garde to play Villa ’s youngsters ; namechecks one particular talent - HITC #avfc URL498	PROPN PROPN PROPN NOUN PART VERB PROPN PART PROPN PUNCT PROPN NUM ADJ NOUN PUNCT PROPN PROPN X
RT @USER52 : Godfather behind the scenes URL1315	X X PUNCT VERB ADP DET NOUN NOUN
Sushi time in 3 , 2 , 1 ...	ADJ NOUN ADP NUM PUNCT NUM PUNCT NUM PUNCT
RT @USER108 : Such a good thing to have on ur phone . Push the button when u feel unsafe and when u let it go if u do nt enter ur pin they …	X X PUNCT VERB DET ADJ NOUN PART VERB ADP PRON NOUN PUNCT VERB DET NOUN ADV PRON VERB ADJ CCONJ ADV PRON VERB PRON VERB SCONJ PRON AUX PART VERB PRON VERB PRON PUNCT
RT @USER281 : The Eyenimal Cat Video Camera w/ nightvision ! - URL1052	X X PUNCT DET NOUN NOUN NOUN NOUN ADP PROPN PUNCT PUNCT PROPN
RT @USER1268 : Can you really make $ 64000 / mo just signing people up with a code ? We review Smash Fund URL1371 URL219 …	X X PUNCT AUX PRON ADV VERB SYM PROPN PUNCT PROPN ADV VERB NOUN ADP ADP DET NOUN PUNCT PRON NOUN PROPN NOUN X X PUNCT
RT @USER814 : This shit hilarious 😂😂 URL1588	X X PUNCT DET NOUN ADJ SYM X
RT @USER983 : #Trump knows how to make his bank coffers " Great Again " right ? What a con artist . URL257	X X PUNCT PROPN VERB ADV PART VERB PRON NOUN NOUN PUNCT ADJ NOUN PUNCT INTJ PUNCT PRON DET X NOUN PUNCT X
RT @USER1584 : 15 - year - old youth speaker @USER788 ca n't be silenced . URL1526	X X PUNCT NUM PUNCT NOUN PUNCT ADJ NOUN NOUN NOUN AUX PART AUX ADJ PUNCT X
goal with @USER691 URL431	NOUN ADP PROPN NOUN
RT @USER1330 : Gay Nightclub Shooting The Deadliest In History Of America ! The Mixed Reactions To The Horror Will Shock You ! URL221 …	X X PUNCT ADJ NOUN VERB DET ADJ ADP NOUN ADP PROPN PUNCT DET NOUN NOUN ADP DET NOUN AUX VERB PRON PUNCT X PUNCT
Gerime The Menace ... 😅😅	VERB DET NOUN PUNCT X
RT @USER454 : Make hundreds of dollars / week playing around on Facebook / Twitter ! URL1636 URL1606	X X PUNCT VERB ADJ ADP NOUN PUNCT NOUN VERB ADP ADP PROPN PUNCT PROPN PUNCT VERB NOUN
#CareerArc #Retail #Job alert : Manager Trainee - Retail Sales | Speedway | #Brimfield , OH URL664 #Jobs #Hiring	PROPN PROPN PROPN NOUN PUNCT PROPN NOUN PUNCT PROPN NOUN SYM PROPN SYM PROPN PUNCT PROPN PROPN NOUN X
RT @USER756 : @USER424 Very proud to be in top 3 ' Best places to Work ' , fingers crossed for Thursday - great write up #Awards ht …	X X PUNCT VERB ADV ADJ PART AUX ADP NOUN NUM PUNCT ADJ NOUN ADP PROPN PUNCT PUNCT NOUN VERB ADP PROPN PUNCT ADJ VERB ADP X X PUNCT
RT @USER2215 : I agree . I do not HATE Muslims . They have NUMEROUS Muslims majority countries where they can go & be happy . URL222 …	X X PUNCT PRON VERB PUNCT PRON AUX PART ADJ PROPN PUNCT PRON VERB ADJ PROPN PROPN NOUN ADV PRON AUX VERB CCONJ AUX ADJ PUNCT X PUNCT
RT @USER1093 : good ideas URL241	X X PUNCT ADJ NOUN NOUN
Dean still needs more recognition though , but elo and g soul are hella good , I love them URL1239	PROPN ADV VERB ADJ NOUN ADV PUNCT CCONJ VERB CCONJ NOUN NOUN AUX ADV ADJ PUNCT PRON VERB PRON SYM
RT @USER2159 : a year later and things have n't changed	X X PUNCT DET NOUN ADV CCONJ NOUN VERB PART VERB
Tickets go on sale in 2 minutes and both my parents are upstairs . I 'm not getting tickets .	PROPN VERB ADP NOUN ADP NUM NOUN CCONJ DET PRON NOUN AUX NOUN PUNCT PRON AUX PART VERB NOUN PUNCT
@USER642 will score more than #Wade next year and be a better 3pt #shooter than Wade ever was #thankswade #enjoyrondo #goheat #MiamiHeat	PROPN AUX VERB ADJ ADP PROPN ADJ NOUN CCONJ AUX DET ADJ NOUN VERB SCONJ PROPN ADV AUX ADJ PROPN NOUN NOUN
Such a beautiful day to be " atropelado " - by @USER1638	VERB DET ADJ NOUN PART AUX PUNCT PROPN PUNCT PUNCT ADP PROPN
It 's sad that I had to part ways with my bmcc and Zeiss primes as I had to sell it to pay off my first camera FS 100 as it dropped $ 7 k MSRP	PRON AUX ADJ SCONJ PRON VERB ADP NOUN NOUN ADP PRON NOUN CCONJ VERB VERB SCONJ PRON VERB PART VERB PRON PART VERB ADP PRON ADJ NOUN NOUN NUM ADP PRON VERB SYM NUM NUM NOUN
Iphone app gemmation prefab unadulterated – indivisible guests shines eminent the break : IbcLBe	PROPN NOUN PROPN PROPN PROPN PUNCT PROPN PROPN NOUN VERB DET NOUN PUNCT X
#Boston #Job Treasury Analyst : MA - Boston , The Treasury Analyst will contribute to the day - to - day financial act ... URL1201	PROPN PROPN PROPN NOUN PUNCT PROPN PUNCT PROPN PUNCT DET NOUN NOUN AUX VERB ADP DET NOUN PUNCT ADP PUNCT NOUN PROPN VERB PUNCT X
RT @USER1130 : I just drove 4 hours to sleep less than six hours and speak tomorrow morning for 2 minutes . LOL ..... I 'm hooked ! #Toastma …	X X PUNCT PRON ADV VERB NUM NOUN PART NOUN ADJ ADP NUM NOUN CCONJ VERB NOUN NOUN ADP NUM NOUN PUNCT INTJ PUNCT PRON AUX ADJ PUNCT PROPN PUNCT
@USER14 FOLLOW & RT to #WIN this stunning @USER285 set for your dad this Father 's Day with 4 x @USER7 . Good Luck !	PROPN NOUN CCONJ VERB PART VERB DET NOUN NOUN NOUN ADP PRON NOUN DET NOUN PART NOUN ADP NUM SYM PROPN PUNCT ADJ NOUN PUNCT
RT @USER2416 : Me right now URL1352	X X PUNCT PRON ADV ADV SYM
RT @USER1822 : My #TeenChoice for #ChoiceModel is @USER507 URL1154	X X PUNCT PRON NOUN ADP PROPN AUX PROPN X
Tombstone will always be my favorite movie .	PROPN AUX ADV AUX PRON ADJ NOUN PUNCT
RT @USER2436 : 1606165 093229 || Scheduling for multiple dates / times to twitter with just text	X X PUNCT PROPN NOUN PROPN NOUN ADP PROPN NOUN PUNCT NOUN PART PROPN ADP ADV NOUN
RT @USER708 : We are not saved by any work we 've done , but by the grace and mercy of God .	X X PUNCT PRON AUX PART VERB ADP DET NOUN PRON AUX ADJ PUNCT CCONJ ADP DET NOUN CCONJ NOUN ADP PROPN PUNCT
RT @USER1217 : my face vs my soul URL1294	X X PUNCT PRON NOUN ADP PRON NOUN SYM
RT @USER1246 : depression is n't always at 3 am , sometimes it hits you at 3 pm when you 're with friends , halfway through a laugh and suddenly …	X X PUNCT PROPN AUX PART ADV ADP NUM NOUN PUNCT SCONJ PRON VERB PRON ADP NUM NOUN ADV PRON AUX ADP NOUN PUNCT VERB ADP DET NOUN CCONJ NOUN PUNCT
@USER2454 @USER1797 @USER1687 I ca n't talk the lass at the hair dressers asked me if she wanted me to trim my brows . #theshame	PROPN PROPN PROPN PRON AUX PART VERB DET NOUN ADP DET NOUN NOUN VERB PRON SCONJ PRON VERB PRON PART VERB PRON NOUN PUNCT X
RT @USER251 : Find the cheapest flights by comparing hundreds of airlines and travel sites URL773 URL1515 …	X X PUNCT VERB DET NOUN NOUN SCONJ VERB NOUN ADP PROPN CCONJ PROPN PROPN PROPN X PUNCT
@USER611 @USER2175 add me back too	PROPN PROPN VERB PRON ADV ADV
RT @USER1338 : This is exactly how this song makes me feel lol URL1429	X X PUNCT PRON AUX ADV ADV DET NOUN VERB PRON VERB INTJ SYM
#Earthquake ( #sismo ) M2.7 strikes 21 km E of #Everett ( #Washington ) 5 min ago . More info : URL1512	PROPN PUNCT PROPN PUNCT PROPN VERB NUM NOUN X ADP PROPN PUNCT PROPN PUNCT NUM PROPN ADV PUNCT ADJ NOUN PUNCT X
RT @USER374 : Stay in my life and I swear I 'll stay in yours .	X X PUNCT VERB ADP PRON NOUN CCONJ PRON VERB PRON AUX VERB ADP PRON PUNCT
RT @USER2608 : @USER2488 @USER1906 @USER56 sorry for your loss	X X PUNCT PROPN PROPN NOUN ADJ ADP PRON NOUN
RT @USER961 : Before they tip the #ECF tomorrow , we flash back to #TheAssociation during @USER1100 record - setting season ! URL867	X X PUNCT SCONJ PRON NOUN DET ADJ NOUN PUNCT PRON VERB ADV PART VERB ADP PROPN NOUN PUNCT VERB NOUN PUNCT X
RT @USER2263 : @USER530 Give me strength to walk on Your principles Guru Ji #HumanityAimsOfMSG	X X PUNCT X VERB PRON NOUN PART VERB ADP PRON PROPN PROPN PROPN SYM
RT @USER1837 : me : i saw on fb you had a baby friend : ya me : how much does he bench friend : what me : [ leans in to his ear ] how much . doe …	X X PUNCT PRON PUNCT PRON VERB ADP PROPN PRON VERB DET NOUN NOUN PUNCT INTJ PRON PUNCT ADV ADV AUX PRON VERB NOUN PUNCT PRON PRON PUNCT PUNCT VERB ADP ADP PRON NOUN PUNCT ADV ADV PUNCT ADV PUNCT
This is a serious matter 💕💚 URL335	PRON AUX DET ADJ VERB SYM SYM
Just paid so many bills FML	ADV VERB ADV ADJ NOUN NOUN
sluts gone wild ✅ URL420 URL1423	PROPN VERB PROPN PROPN NOUN X
Triangulation Peak , OR [ OC ] [ 2400 x 1714 ] URL646 URL752	PROPN PROPN PUNCT PROPN PUNCT PROPN PUNCT PUNCT PROPN SYM PROPN PUNCT X X
How many of y'all can disagree with someone without calling them out of their name	ADV ADJ ADP PRON AUX VERB ADP PRON SCONJ VERB PRON ADP ADP PRON NOUN
I liked a @USER1490 video URL1046 GTA 5 ONLINE - HOW TO SAVE BODYGUARD OUTFITS CLOTHING GLITCH ! [ EASY / NEW ] AFTER PATCH	PRON VERB DET PROPN NOUN PROPN PROPN NUM NOUN PUNCT ADV PART PROPN PROPN PROPN PROPN PROPN PUNCT PUNCT PROPN PUNCT ADJ PUNCT ADP NOUN
Just sent an invitation to all my friends on Facebook to stop playing Candy Crush and : go hug someone they love .	ADV VERB DET NOUN PART DET PRON NOUN ADP PROPN PART VERB VERB PROPN PROPN CCONJ PUNCT VERB VERB PRON PRON VERB PUNCT
RT @USER588 : So happy when I 'm with u ❤️	X X PUNCT ADV ADJ ADV PRON AUX ADP PRON SYM
RT @USER612 : the let 's steal tweets squad URL1022	X X PUNCT DET NOUN PART VERB NOUN NOUN X
A GOOD MOM URL1346	DET ADJ NOUN SYM
RT @USER2034 : Why is school a thing ? 🙃📚	X X PUNCT ADV AUX NOUN DET NOUN PUNCT X
I 'm bout to text you URL291	PRON AUX ADJ PART VERB PRON VERB
RT @USER2244 : @USER366 @USER1171 @USER2596 Do I have a secret twin sister that you see around the place ? Govian ? Are you kiddi …	X X PUNCT PROPN PROPN NOUN AUX PRON VERB DET NOUN NOUN NOUN SCONJ PRON VERB ADP DET NOUN PUNCT PROPN PUNCT AUX PRON VERB PUNCT
@USER1708 you 're a great friend to have too ! Thank you 😘❤️	VERB PRON AUX DET ADJ NOUN PART VERB ADV PUNCT VERB PRON SYM
RT @USER1066 : MY LIFE #growingupwithsiblings URL1004	X X PUNCT PRON NOUN NOUN X
RT @USER222 : #Ukraine does not recognize court verdicts vs #Sentsov #Afanasyev #Kolchenko #Soloshenko convicted in #Russia URL222 …	X X PUNCT PROPN AUX PART VERB VERB NOUN ADP PROPN PROPN PROPN PROPN NOUN ADP PROPN X PUNCT
RT @USER2125 : Katy Perry Showing she Her Nips And Camel Toe In A Tight Bikini !!! ( 9 pics ) ////// see here <<<< URL590	X X PUNCT PROPN NOUN VERB PRON PRON NOUN CCONJ VERB NOUN ADP DET NOUN NOUN PUNCT PUNCT NUM PROPN PUNCT PROPN VERB ADV SYM X
RT @USER221 : . @USER1434 needs to listen to @USER150 & pay its fair share : URL588 #StandUp2Vz #BetterMatters URL220 …	X X PUNCT PUNCT PROPN NOUN PART VERB ADP PROPN CCONJ VERB PRON ADJ VERB PUNCT PROPN PROPN X X PUNCT
RT @USER679 : Mood Asf When I 'm High URL652	X X PUNCT PROPN PROPN ADV PRON AUX ADJ NOUN
RT @USER510 : I stalk myself a lot .. Like I 'll go through my own Twitter , Instagram and watch my story way more than I do anyone else lmao …	X X PUNCT PRON VERB PRON DET NOUN PUNCT VERB PRON AUX VERB ADP PRON ADJ PROPN PUNCT PROPN CCONJ VERB PRON NOUN NOUN ADJ SCONJ PRON VERB PRON ADJ INTJ PUNCT
In one state , more children homeschool than attend private schools . Why that should n’t shock you . – … URL992 #homeschool	ADP NUM NOUN PUNCT ADV PROPN NOUN ADP PROPN PROPN PROPN PUNCT ADV PRON AUX PART VERB PRON PUNCT PUNCT PUNCT PROPN X
RT @USER832 : Parents , problems , friends , fakes , love , crush , dating , responsibility , drama , heartache , failures , stress , happiness ; It …	X X PUNCT PROPN PUNCT PROPN PUNCT NOUN PUNCT PROPN PUNCT NOUN PUNCT VERB PUNCT VERB PUNCT PROPN PUNCT PROPN PUNCT PROPN PUNCT PROPN PUNCT VERB PUNCT PROPN PUNCT PRON PUNCT
okay i m watching bates motel byE	INTJ PRON AUX VERB ADJ NOUN X
this is what it 's like to be a vegetarian at school #lent URL547	PRON AUX PRON PRON AUX VERB PART AUX DET ADJ ADP NOUN NOUN X
RT @USER469 : Please share . Missing 18year old is a close friend of my neighbour . URL1028	X X PUNCT INTJ VERB PUNCT VERB PROPN ADJ AUX DET ADJ NOUN ADP PRON NOUN PUNCT X
A panjabi comment on Pakistan Defense : " We are in war with Abdalis , Ghorids and Ghazavids . We have named our ... URL551	DET NOUN NOUN ADP PROPN NOUN PUNCT PUNCT PRON AUX ADP NOUN ADP PROPN PUNCT PROPN CCONJ NOUN PUNCT PRON AUX VERB PRON PUNCT X
RT @USER852 : New patch will be live tomorrow ! We will live stream during #weekend with #giveaway codes ! check out the #indiegame URL221 …	X X PUNCT ADJ NOUN AUX AUX ADJ NOUN PUNCT PRON AUX VERB NOUN ADP NOUN ADP NOUN PROPN PUNCT VERB ADP DET NOUN X PUNCT
RT @USER65 : I want Wayne Gooney 2 come back on twitter & tell me all the players Wenger is going to sign again ... I miss him terribly # …	X X PUNCT PRON VERB PROPN PROPN NUM VERB ADV ADP PROPN CCONJ VERB PRON DET DET NOUN PROPN AUX VERB PART NOUN ADV PUNCT PRON VERB PRON ADJ NOUN PUNCT
RT @USER101 : The Walk - Falling Leaves - Vincent van Gogh , 1889 URL1212	X X PUNCT DET NOUN PUNCT VERB NOUN PUNCT PROPN PROPN PROPN PUNCT PROPN SYM
Almost as beautiful as you are conceited , she thought at him , and he laughed out loud .	VERB SCONJ ADJ SCONJ PRON AUX NOUN PUNCT PRON VERB ADP PRON PUNCT CCONJ PRON VERB ADP PROPN PUNCT
Spend 80 on a watch she call me Dada	VERB ADJ ADP DET NOUN PRON VERB PRON VERB
Stolen Christopher Columbus Letter Returned to Italy - Discovery News : Discovery NewsStolen Christopher Colum ... URL274	PROPN PROPN PROPN PROPN NOUN ADP PROPN PUNCT PROPN NOUN PUNCT PROPN PROPN PROPN NOUN PUNCT X
RT @USER1470 : Lord , lead me so I can lead others .	X X PUNCT PROPN PUNCT VERB PRON ADV PRON AUX ADJ NOUN PUNCT
RT @USER1436 : Him : Can you be serious for a moment Me : URL737	X X PUNCT PROPN PUNCT AUX PRON AUX ADJ ADP DET NOUN PRON PUNCT X
@USER171 @USER1134 do you realize that if Jimmy G gets hurt all they have left is Brissett ? Are they really not signing a veteran ?	PROPN PROPN AUX PRON VERB PRON SCONJ PROPN X VERB ADJ DET PRON VERB ADJ AUX PROPN PUNCT AUX PRON ADV PART VERB DET NOUN PUNCT
@USER77 🙏🏻 thank god	PROPN PROPN VERB NOUN
Return all the money you stole from Kofi Amoabeng ’s drawer – Diamond ‘ slaps ’ Mzbel URL1379 URL1325	VERB DET DET NOUN PRON VERB ADP PROPN NOUN PART PROPN PUNCT NOUN PUNCT PROPN PUNCT PROPN NOUN X
RT @USER1020 : I hate saying this but uhh " I still love you " .	X X PUNCT PRON VERB VERB PRON CCONJ NOUN PUNCT PRON ADV VERB PRON PUNCT PUNCT
RT @USER1072 : Come to the dark side . #BrexitIn5Words URL322	X X PUNCT VERB ADP DET ADJ NOUN PUNCT X SYM
RT @USER2049 : " Jesus said ' At the moment you do not know what I am doing , but later you will understand . ' " - John 13:7	X X PUNCT PUNCT PROPN VERB PUNCT ADP DET NOUN PRON AUX PART VERB PRON PRON AUX VERB PUNCT CCONJ ADV PRON AUX VERB PUNCT PUNCT PUNCT PUNCT PROPN PROPN
Congratulatory message for Kstyle 's 4 years ! URL538	PROPN NOUN ADP PROPN PART NUM NOUN PUNCT X
RT @USER957 : What 's real does n't fade away .	X X PUNCT PRON AUX ADJ AUX PART VERB ADV PUNCT
RT @USER2202 : oh nazuna was actually thinking of going back to valkyrie after ra*bits gets on the right track but he does n't want to leave …	X X PUNCT INTJ NOUN AUX ADV VERB SCONJ VERB ADV PART VERB SCONJ PROPN VERB ADP DET ADJ NOUN CCONJ PRON AUX PART VERB PART VERB PUNCT
RT @USER1882 : old enough URL796	X X PUNCT ADJ ADJ NOUN
RT @USER498 : Crikey ! Manchester United have sacked Louis Van Gaal . Who saw that coming ? Next thing you know they 'll appoint José Mourin …	X X PUNCT PROPN PUNCT PROPN PROPN VERB PROPN PROPN PROPN PROPN PUNCT PRON VERB PRON VERB PUNCT ADJ NOUN PRON VERB PRON AUX VERB PROPN NOUN PUNCT
By Pass ! #np	ADP PROPN PUNCT X
Hold up ?! Knicks beat Bulls back to back ?!	VERB ADP PUNCT PROPN VERB PROPN ADV ADP ADV PUNCT
RT @USER833 : ME - YOU URL1366	X X PUNCT PRON PUNCT PRON VERB
I am playing Online Head Ball with real players . Download now : URL405 #OnlineHeadball #HeadBall	PRON AUX VERB ADJ NOUN NOUN ADP ADJ NOUN PUNCT SYM ADV PUNCT PROPN NOUN NOUN
RT @USER1352 : Like a proud papa silverback , just look at this talented cool / hot #Baywatch cast .. ilfenator , … URL1523	X X PUNCT ADP DET ADJ NOUN NOUN PUNCT ADV VERB ADP DET ADJ ADJ PUNCT ADJ NOUN NOUN PUNCT PROPN PUNCT PUNCT X
RT @USER2074 : Whoa . This letter from @USER2550 on the FBI request is incredible and unprecedented . Read it now . URL1185 …	X X PUNCT PROPN PUNCT PRON NOUN ADP NOUN ADP DET PROPN PROPN AUX ADJ CCONJ NOUN PUNCT VERB PRON ADV PUNCT X PUNCT
If you were an elevator , what button would I have to push to get you to go down ? #MyBestPickupLines	SCONJ PRON AUX DET NOUN PUNCT PRON NOUN AUX PRON VERB PART VERB PART VERB PRON PART VERB ADV PUNCT X
RT @USER137 : " Not that we lord it over your faith , but we work with you for your joy . " 2 Corinthians 1:24 #GoodFaith URL533 …	X X PUNCT PUNCT SCONJ SCONJ PRON VERB PRON ADP PRON NOUN PUNCT CCONJ PRON VERB ADP PRON ADP PRON NOUN PUNCT PUNCT NUM PROPN PROPN PROPN X PUNCT
RT @USER1137 : British @USER1861 astronaut #TimPeake meets Apollo 15 @USER960 astronaut Al Worden ! #Astronaut #Apollo15 #FIA16 URL1589 …	X X PUNCT PROPN PROPN PROPN PROPN NOUN NOUN NUM NOUN PROPN PROPN PROPN PUNCT PROPN PROPN NOUN X PUNCT
RT @USER2132 : Tell Me What Is Love - D.O ( from EXO ) URL170	X X PUNCT VERB PRON PRON AUX VERB PUNCT PROPN PUNCT ADP PROPN PUNCT X
RT @USER569 : Word URL330	X X PUNCT PROPN SYM
A cracking in the pattern , a miracle waiting to happen URL285	DET VERB ADP DET NOUN PUNCT DET NOUN VERB PART VERB SYM
Just posted a photo URL774	ADV VERB DET NOUN X
RT @USER2081 : Justin Bieber 's Statements About Selena Gomez Will Forever Smash Her Hopes And Dreams see URL927 URL218 …	X X PUNCT PROPN PROPN PART ADJ ADJ PROPN PROPN AUX ADV VERB PRON NOUN CCONJ NOUN VERB X X PUNCT
RT @USER1193 : dis could be us but you praying URL318	X X PUNCT PRON AUX AUX PRON CCONJ PRON VERB X
RT @USER2018 : I hate when chicks be like " At the end of the day he coming home 🏠 to me " 💁🏾 ... DUH !! bitch she ai n't letting his ass stay ov …	X X PUNCT PRON VERB ADV NOUN AUX SCONJ PUNCT SCONJ DET NOUN ADP DET NOUN PRON VERB ADV NOUN ADP PRON PUNCT PROPN PUNCT PROPN PUNCT NOUN PRON AUX PART VERB PRON NOUN VERB NOUN PUNCT
RT @USER102 : If you want people to pay to win , make a pay to play game . Do n't pretend that the game is playable for free if you have to …	X X PUNCT SCONJ PRON VERB NOUN PART VERB PART VERB PUNCT VERB DET NOUN PART VERB NOUN PUNCT AUX PART VERB SCONJ DET NOUN AUX ADJ SCONJ ADJ SCONJ PRON VERB PART PUNCT
@USER254 they do n't have anything on you bc you 're a bomb ass person 😴😘	SCONJ PRON AUX PART VERB PRON ADP PRON SCONJ PRON AUX DET ADJ NOUN NOUN X
@USER795 nice and cool 72 in my ac fitted home . Should invest . The world@is@only getting warmer	PROPN ADJ CCONJ ADJ ADJ ADP PRON NOUN ADJ NOUN PUNCT AUX VERB PUNCT DET NOUN VERB ADJ
RT @USER333 : Sometimes I feel like we 're friends , sometimes I feel like we 're more than friends , but sometimes I feel like I 'm just a …	X X PUNCT INTJ PRON VERB SCONJ PRON AUX NOUN PUNCT SCONJ PRON VERB SCONJ PRON AUX ADJ ADP NOUN PUNCT CCONJ SCONJ PRON VERB SCONJ PRON AUX ADV DET PUNCT
RT @USER628 : Mala tomorrow land 😂😂 DUTERTE GRAND RALLY URL1378	X X PUNCT PROPN NOUN NOUN SYM PROPN PROPN X X
Pumping up for game day and Shannon nole comes on	VERB ADP ADP NOUN NOUN CCONJ PROPN NOUN VERB ADP
Marco interrupts the yoga onstage at the #GOPDebate as #Cruz tells #Trump to #breathe . #pranayama for #politicians URL982	PROPN VERB DET NOUN NOUN ADP DET NOUN SCONJ NOUN VERB NOUN ADP PROPN PUNCT VERB ADP PROPN X
@USER1339 — been thwarted whenever they had taken a look at his wings . Something so angelic but in their eyes , he was a monster . —	PROPN PUNCT AUX ADJ ADV PRON VERB VERB DET NOUN ADP PRON NOUN PUNCT VERB ADV VERB CCONJ ADP PRON NOUN PUNCT PRON AUX DET NOUN PUNCT PUNCT
@USER1281 @USER1302 handle me with care	PROPN PROPN VERB PRON ADP NOUN
RT @USER1770 : do n't wan na talk to anyone	X X PUNCT AUX PART VERB PART VERB ADP PRON
. @USER536 thanks for the latest #ThreatWire video - ATM skimming up 546 % URL1600	PUNCT PROPN NOUN ADP DET ADJ NOUN NOUN PUNCT NOUN VERB ADP PROPN SYM X
@USER2053 @USER917 could n't it be considered a positive that it 's not news when something like this happens ?	PROPN PROPN AUX PART PRON AUX VERB DET NOUN SCONJ PRON AUX PART NOUN ADV PRON VERB PRON VERB PUNCT
RT @USER2167 : " You better ride that dick like a soldier " URL634	X X PUNCT PUNCT PRON ADV VERB PRON NOUN ADP DET NOUN PUNCT SYM
Dover riots : Protesters burnt EU flag as migration anger spirals out of control URL1142	PROPN PROPN PUNCT PROPN PROPN VERB VERB ADP PROPN PROPN VERB ADP ADP PROPN X
RT @USER2051 : RT to WIN : ABH 's Moon Child glow kit :) mbf URL1584	X X PUNCT VERB ADP VERB PUNCT PROPN PART ADJ NOUN PROPN PROPN SYM X X
@USER147 Okay , but why ?	PROPN INTJ PUNCT CCONJ ADV PUNCT
There is too many humans here 👽	PRON AUX ADV ADJ NOUN ADV SYM
RT @USER2433 : idc what anyone says , it s ok to pay for ya mans meal sometimes . Now a days girls so pressed on the fact that the guy got ta …	X X PUNCT VERB PRON PRON VERB PUNCT PRON AUX ADJ PART VERB ADP PRON NOUN NOUN ADV PUNCT ADV DET NOUN NOUN ADV VERB ADP DET NOUN SCONJ DET NOUN VERB PART PUNCT
RT @USER396 : Instead of telling everyone about feelings , I choose to keep it all insides by me . Because ppl keep leaving me , I know .	X X PUNCT ADV ADP VERB PRON ADP NOUN PUNCT PRON VERB PART VERB PRON DET NOUN ADP PRON PUNCT SCONJ NOUN VERB VERB PRON PUNCT PRON VERB PUNCT
My head hurts ..........	PRON NOUN VERB SYM
RT @USER2083 : Bitches live for the internet flex 😩	X X PUNCT PROPN VERB ADP DET NOUN NOUN SYM
The revolution may be televised ...	DET NOUN AUX AUX ADJ PUNCT
URL844 Cadet World Team training at Harwich , fantastic weather , a great team .... yes this is Great Britain @USER486	PROPN PROPN PROPN NOUN NOUN ADP PROPN PUNCT PROPN NOUN PUNCT DET ADJ NOUN PUNCT INTJ PRON AUX ADJ PROPN SYM
RT @USER1501 : If elected Mayor , I 'll improve London 's living environment . Add your name to back my plan : URL1385 URL218 …	X X PUNCT SCONJ ADJ NOUN PUNCT PRON AUX VERB PROPN PART NOUN NOUN PUNCT VERB PRON NOUN PART VERB PRON NOUN PUNCT X X PUNCT
Lowe 's purchase of RONA positive for ... : LITTLE CURRENT — American retailing giant Lowe 's Company Inc. is purcha ... URL958	PROPN PART VERB ADP PROPN NOUN ADP PUNCT PUNCT PROPN PROPN PUNCT ADJ PROPN ADJ NOUN PART NOUN NOUN AUX ADJ PUNCT X
“ @USER1939 : Call yo friends let 's get DRUNK 😛 URL919 ”	PUNCT PROPN PUNCT VERB INTJ NOUN VERB PART VERB ADJ PROPN NOUN PUNCT
RT @USER2056 : for a wife , for a husband . To whoever you date ; are they the one or are you just playing games ? URL802	X X PUNCT ADP DET NOUN PUNCT ADP DET NOUN PUNCT PART VERB PRON NOUN PUNCT AUX PRON DET NOUN CCONJ AUX PRON ADV VERB NOUN PUNCT SYM
@USER850 is @USER2377 3rd wife and his children are from all three not very Christian	PROPN AUX PROPN PROPN NOUN CCONJ PRON NOUN VERB ADP DET ADJ PART ADV ADJ
RT @USER393 : [ ! ] 160601 EXO 's 3rd full length album is titled EX ' ACT URL320	X X PUNCT PUNCT PUNCT PUNCT PROPN NOUN PART ADJ ADJ NOUN NOUN AUX ADJ PROPN PUNCT PROPN NOUN
RT @USER281 : Cat Scared Of Vacuum Cleaner | Funny Video Cat 2016 | Meo Cover House - URL305	X X PUNCT PROPN ADJ ADP PROPN PROPN SYM ADJ NOUN PROPN NUM SYM PROPN NOUN PROPN PUNCT PROPN
RT @USER2276 : The Dark Secrets Of ' Full House ' Will Blow Your Mind URL1296	X X PUNCT DET NOUN NOUN ADP PUNCT ADJ PROPN PUNCT AUX VERB PRON NOUN X
Exclusive first look at Cross Border VAT on Thursday 12th May URL995	ADJ ADJ VERB ADP PROPN PROPN PROPN ADP PROPN NOUN PROPN X
' House of Cards ' season 5 spoilers : Claire destroys Frank while Doug finds love in new season ? - ChristianToday URL1055	PUNCT PROPN ADP NOUN PUNCT NOUN NUM NOUN PUNCT PROPN PROPN PROPN SCONJ PROPN PROPN NOUN ADP ADJ NOUN PUNCT PUNCT PROPN NOUN
That flash tho x2 URL1323	PRON VERB ADV SYM SYM
Csgo #ELEAGUE live on #tbs !!!!!!! URL1571	PROPN PROPN VERB ADP PROPN PUNCT X
@USER622 " I think you are fortunate she has a tender heart . I would suffer her wrath if we fought . But I am watching you . "	PROPN PUNCT PRON VERB PRON AUX ADJ PRON AUX DET ADJ NOUN PUNCT PRON AUX VERB PRON NOUN SCONJ PRON VERB PUNCT CCONJ PRON AUX VERB PRON PUNCT PUNCT
RT @USER1544 : 3 more months until graduation 💃🏿	X X PUNCT NUM ADJ NOUN ADP NOUN X
RT @USER128 : GIMME URL283	X X PUNCT VERB NOUN
#LetterFromTheBrooks please choose me , a will frame it & put it on my wall 📃 !!!!! I love & miss use sm 😘 @USER1368 😇	PROPN INTJ VERB PRON PUNCT DET AUX VERB PRON CCONJ VERB PRON ADP PRON NOUN NOUN PUNCT PRON VERB CCONJ VERB NOUN PROPN SYM X X
RT @USER2180 : How much longer can @USER1037 ignore #USURY and #PAEDOPHILA and hide #EMBRYOLOGY from MOTHERS ? Such simple math / science . @ …	X X PUNCT ADV ADV ADV AUX VERB VERB NOUN CCONJ NOUN CCONJ VERB VERB ADP PROPN PUNCT PROPN PROPN NOUN PUNCT PROPN PUNCT ADP PUNCT
Ok done being sap . Here 's Zola waiting for her treat 🐶 URL1337	INTJ AUX AUX NOUN PUNCT ADV PART VERB VERB ADP PRON NOUN NOUN X
RT @USER1186 : RT IF #GreenWall URL643	X X PUNCT VERB ADP NOUN X
URL490 Temp : 8.7 °C Wind : 6.9 mph Pressure : 1010.6 mb Falling Rain Today 0.0 mm Hum 69 % Fc : Occasional precipitation , worsening	PROPN PROPN PUNCT PROPN NOUN NOUN PUNCT PROPN NOUN X PUNCT PROPN NOUN VERB NOUN NOUN NUM NOUN NOUN X SYM X PUNCT PROPN NOUN PUNCT SYM
RT @USER2016 : Bellerin was member in PFA team of a year and Ismed Sofyan can deliver much better cross than him .	X X PUNCT PROPN AUX NOUN ADP PROPN NOUN ADP DET NOUN CCONJ NOUN NOUN AUX VERB ADV ADJ NOUN ADP PRON PUNCT
finna hit him with that " you up " text 😩	PROPN VERB PRON ADP PRON PUNCT PRON ADV PUNCT VERB SYM
RT @USER2598 : " when did you start crying ? " URL835	X X PUNCT PUNCT ADV AUX PRON VERB VERB PUNCT PUNCT SYM
@USER1844 @USER2432 we all know that jen wants jimin :)	PROPN PROPN PRON DET VERB SCONJ NOUN VERB VERB SYM
RT @USER448 : These crossover episodes were lit URL974	X X PUNCT DET NOUN NOUN AUX VERB NOUN
@USER1446 what ? 😂😂😂	VERB PRON PUNCT SYM
RT @USER1445 : The world not ready URL1605	X X PUNCT DET NOUN PART ADJ NOUN
RT @USER914 : Never give up on someone you ca n't go a day without thinking about .	X X PUNCT ADV VERB ADP ADP PRON PRON AUX PART VERB DET NOUN SCONJ VERB ADP PUNCT
Lee Joon fights the temptation to suck ? URL583 #kpop #kpopmusic	PROPN PROPN VERB DET NOUN ADP PROPN PUNCT PROPN PROPN X
AllGreen News : URL276 Top posts from : @USER1716 @USER319	PROPN NOUN PUNCT PROPN ADJ NOUN ADP PUNCT PROPN X
Shades Of Childhood Ruined , Make Sure You Close Your Eyes URL1291 URL1236	VERB ADP PROPN PROPN PUNCT VERB INTJ PRON VERB PRON NOUN NOUN X
Philips B 120 In.Sight Wireless HD Baby Monitor For IOS iPad iPhone Camera URL1089	PROPN PROPN PROPN PROPN PROPN PROPN NOUN NOUN ADP PROPN PROPN PROPN X X
@USER2641 actually let all ships in svtfoe be platonic	PROPN ADV VERB DET NOUN ADP PROPN AUX ADJ
RT @USER2160 : 4x cause i liked my outfit from yesterday 💙 URL991	X X PUNCT VERB SCONJ PRON VERB PRON NOUN ADP NOUN SYM X
Kingpin killed as robbers , police engage in shootout in Aba URL1632	PROPN VERB ADP PROPN PUNCT NOUN NOUN ADP NOUN ADP PROPN NOUN
@USER2108 I wan na comment on your lovely smile but Dems gets all my attention . His unlooking is TIGHT !	PROPN PRON VERB PART VERB ADP PRON ADJ NOUN CCONJ VERB VERB DET PRON NOUN PUNCT PRON NOUN AUX ADJ PUNCT
You ai n't lying b 😂😂 URL511	PRON AUX PART VERB NOUN SYM X
RT @USER972 : When are we going to run out of usernames ?	X X PUNCT ADV AUX PRON VERB PART VERB ADP ADP PROPN PUNCT
RT @USER1697 : Follow everyone who retweets this 👀	X X PUNCT VERB PRON PRON VERB PRON NOUN
Multibionta 50 + Tablets - 30 Tablets - Pack of 2 - URL1529	PROPN NUM NUM PROPN PUNCT NUM PROPN PUNCT NOUN ADP NUM PUNCT PROPN
@USER1379 hi tisha hope you and your family are well take care 😀 xxxdavid	PROPN INTJ PROPN VERB PRON CCONJ PRON NOUN AUX ADV VERB NOUN SYM X
@USER194 #FiresideBricky meal . Chicken noodle soup and chai tea . URL669	PROPN ADJ NOUN PUNCT NOUN PROPN NOUN CCONJ ADJ NOUN PUNCT X
RT @USER2112 : The heart wants what it wants	X X PUNCT DET NOUN VERB PRON PRON VERB
RT @USER1570 : if i cry in front of you , just know , i reached my limit	X X PUNCT SCONJ PRON VERB ADP ADJ ADP PRON PUNCT ADV VERB PUNCT PRON VERB PRON NOUN
I left my yeti cup at my house this morning and come back to it just now to see that there is still ice in it 😍👍🏼	PRON VERB PRON ADJ PROPN ADP PRON NOUN DET NOUN CCONJ VERB ADV ADP PRON ADV ADV PART VERB SCONJ PRON AUX ADV VERB ADP PRON VERB
Fuck sake Ronaldo 😠 #Euros2016	INTJ NOUN PROPN NOUN X
@USER1387 what that mouth do	VERB PRON PRON NOUN VERB
RT @USER352 : HOW DOES BEN SIMMONS MAKE THIS PASS ? URL929	X X PUNCT ADV PROPN PROPN NOUN VERB PRON NOUN PUNCT X
@USER555 these kids on UMG but we won first then my teammates host was shit and last map went round 11	VERB DET NOUN ADP PROPN CCONJ PRON VERB ADV ADV PRON ADJ NOUN AUX NOUN CCONJ ADJ NOUN VERB NOUN NUM
RT @USER472 : " How old are u ? " * says age * " Awwww u r a baby ! " URL416	X X PUNCT PUNCT ADV ADJ AUX PRON PUNCT PUNCT PUNCT VERB ADJ PUNCT PUNCT VERB PRON AUX DET NOUN PUNCT PUNCT SYM
@USER1469 I watched the first three seasons , and i really liked it lol . Have nt seen it since though , i do nt watch much tv anymore .	PROPN PRON VERB DET ADJ ADJ NOUN PUNCT CCONJ PRON ADV VERB PRON INTJ PUNCT AUX PART VERB PRON ADP ADV PUNCT PRON AUX PART VERB ADJ NOUN ADV PUNCT
RT @USER871 : me as an eyeshadow URL1543	X X PUNCT PRON ADP DET NOUN NOUN
I found 494 people do not follow me back ( via URL1135 )	PRON VERB ADJ NOUN AUX PART VERB PRON ADV PUNCT ADP PROPN PUNCT
@USER183 do n't think the team had much say in where they drafted .	PROPN AUX PART VERB DET NOUN VERB ADV VERB ADP ADV PRON NOUN PUNCT
RT @USER541 : What if his name was James boob instead of James Bond haha	X X PUNCT PRON SCONJ PRON NOUN AUX PROPN NOUN ADV ADP PROPN PROPN INTJ
@USER190 @USER2091 she does nt read email , only k3 - mail and KKC - mail	PROPN PROPN PRON AUX PART VERB NOUN PUNCT ADV NOUN PUNCT NOUN CCONJ NOUN PUNCT NOUN
Cuba does n’t have trendy food trucks as some places do , but it does have an outdoor hot dog stand if you are ... URL1489	PROPN AUX PART VERB ADJ NOUN NOUN ADP DET NOUN VERB PUNCT CCONJ PRON AUX VERB DET ADJ ADJ NOUN VERB SCONJ PRON AUX PUNCT X
RT @USER1263 : by Finbarr Notte , inspired in the amazing beauty of #lacandelaviva #streetart @USER2141 @USER1888 URL574 …	X X PUNCT ADP PROPN NOUN PUNCT VERB ADP DET ADJ NOUN ADP PROPN PROPN PROPN X X PUNCT
Be first to apply - Retail Store Manager in Santa Cruz , CA URL984 #job	AUX ADJ ADP PROPN PUNCT PROPN PROPN NOUN ADP PROPN PROPN PUNCT PROPN PROPN NOUN
Gamer thug tears URL519	PROPN PROPN NOUN NOUN
RT @USER426 : RT @USER655 : Day 1 of install at #FDIC2016 URL1215	X X PUNCT X X PUNCT NOUN NUM ADP NOUN ADP PROPN NOUN
RT @USER1443 : " I hate Donald Trump " URL1255	X X PUNCT PUNCT PRON VERB PROPN PROPN PUNCT PROPN
RT @USER2597 : THE SEX SCENE URL383	X X PUNCT DET NOUN NOUN X
not going to change ...... lol	PART VERB PART VERB PROPN INTJ
RT @USER1199 : Tonight the @USER1200 World Tour kicks off with #ShawnWorldTourCologne 🙆🏻 URL1629	X X PUNCT VERB DET NOUN PROPN NOUN VERB ADP ADP PROPN PROPN X
RT @USER1275 : @USER737 @USER1807 I like that " United States of America V Pete Santili " hahahaha #Oregonstandoff	X X PUNCT PROPN PROPN PRON VERB PRON PUNCT PROPN PROPN ADP PROPN X X NOUN PUNCT INTJ X
' Pepper Spray Cop ' Gets $ 38,000 in Workers ' Comp URL702	PUNCT PROPN PROPN PROPN PUNCT PROPN SYM PROPN ADP PROPN PUNCT PROPN X
Expect you to change it , but I like Roman . It 'll forever remind me about earlier . " @USER794	VERB PRON PART VERB PRON PUNCT CCONJ PRON VERB PROPN PUNCT PRON AUX ADV VERB PRON ADP ADJ PUNCT PUNCT SYM
I need a new phone case 😖	PRON VERB DET ADJ NOUN NOUN X
RT @USER1102 : Thanks to U.S. Imperialism and Racism , Attacks on Muslims in Europe Increase - URL1332 URL424 …	X X PUNCT NOUN ADP PROPN PROPN CCONJ NOUN PUNCT VERB ADP NOUN ADP PROPN PROPN PUNCT PROPN NOUN PUNCT
RT @USER1150 : Qualify for a Place at the #AV/IT Leadership Summit , Aug 10 - 11 , in NYC #AVtweeps URL1127	X X PUNCT VERB ADP DET NOUN ADP DET NOUN PROPN NOUN PUNCT PROPN NUM PUNCT NUM PUNCT ADP PROPN PROPN X
@USER203 waiting for buses to celebrate #July4Canada URL1608	PROPN VERB ADP NOUN ADP PROPN PROPN X
RT @USER1047 : Rockstar in pune URL354	X X PUNCT VERB ADP PROPN X
RT @USER1808 : get yourself a girl who can do both URL937	X X PUNCT VERB PRON DET NOUN PRON AUX VERB DET NOUN
RT @USER2043 : #GrowingUpUgly #GrowingUpFat Not having crushes because you automatically know they 're not gon na like you back	X X PUNCT PROPN NOUN PART VERB NOUN SCONJ PRON ADV VERB PRON AUX PART VERB PART VERB PRON ADV
@USER1788 this weekend will be good tho	VERB DET NOUN AUX AUX ADJ ADV
I leave for college in 51 days 😝😝	PRON VERB ADP NOUN ADP PROPN NOUN X
Iron Man , the Hulk and Frozen 's Anna arrested in New York - Evening Express URL297 via @USER421	NOUN NOUN PUNCT DET NOUN CCONJ NOUN PART PROPN NOUN ADP PROPN PROPN PUNCT PROPN PROPN NOUN ADP PROPN
did we bother to ask if we should ’ve let this happen URL1622	AUX PRON VERB PART VERB SCONJ PRON AUX VERB VERB PRON VERB NOUN
RT @USER2386 : do U think uber drivers get lonely when their passengers leave	X X PUNCT AUX PRON VERB PROPN NOUN VERB NOUN ADV PRON VERB VERB
RT @USER1868 : My #TeenChoice for #ChoiceModel is @USER507	X X PUNCT PRON NOUN ADP PROPN AUX ADJ
@USER245 both	VERB DET
#Taurus Dolls make awesome moms ! They 're strict and loving .	PROPN PROPN VERB ADJ NOUN PUNCT PRON AUX ADJ CCONJ VERB PUNCT
Driver continuing to drive around 60 - 65 miles an hour on 91 Eastbound . @USER210 #KCAL9	PROPN NOUN PART VERB ADP NUM PUNCT PROPN VERB DET NOUN ADP PROPN PROPN PUNCT X X
RT @USER525 : Our tennis warm up 🎾 @USER300 URL948	X X PUNCT PRON NOUN ADJ ADP PROPN NOUN X
[ eBay.ca ] Nexus 5x $ 31 free shipping URL327 URL1250	PUNCT PROPN PUNCT PROPN PROPN SYM PROPN ADJ NOUN NOUN X
so at least I broke 1600 . Still sad I did n't make 1700 though . If only I had good teammates earlier , then I probably would 've made it	ADV ADV ADV PRON VERB PROPN PUNCT ADV ADJ PRON AUX PART VERB VERB ADV PUNCT SCONJ ADV PRON VERB ADJ ADJ ADV PUNCT ADV PRON ADV AUX AUX VERB PRON
@USER2140 oh shoot I ai n't getting that I need to look poppin in flash pics	PROPN INTJ PROPN PRON AUX PART VERB SCONJ PRON VERB PART VERB NOUN ADP PROPN X
Let your workings remain a mystery . Just show people the results . - Lao - tzu URL602	VERB PRON NOUN VERB DET NOUN PUNCT ADV VERB NOUN DET NOUN PUNCT PUNCT PROPN PUNCT PROPN X
RT @USER766 : RT for the chance to WIN this Minority Report inspired T-shirt before we officially release it . URL870	X X PUNCT VERB ADP DET NOUN PART VERB DET NOUN NOUN NOUN VERB SCONJ PRON VERB VERB PRON PUNCT X
RT @USER1193 : If you do n't think your friends have the ability to break your heart , you are so so wrong .	X X PUNCT SCONJ PRON AUX PART VERB PRON NOUN VERB DET NOUN PART VERB PRON NOUN PUNCT PRON AUX ADV ADV ADJ PUNCT
RT @USER2039 : At this point I do n't care if I 'm rude to guys like what part do n't ya fucking understand I do n't wan na talk to anyone	X X PUNCT ADP DET NOUN PRON AUX PART VERB SCONJ PRON AUX ADJ PART NOUN SCONJ PRON NOUN AUX PART PRON ADV VERB PRON AUX PART VERB PART VERB ADP PRON
@USER2179 Help us win & rt these 2 links please ? Thank you & have an amazing day ! 💕 URL798 URL853	PROPN VERB PRON VERB CCONJ VERB DET NUM PROPN INTJ PUNCT VERB PRON CCONJ VERB DET ADJ NOUN PUNCT SYM PROPN X
They are so cute . Congratulations . May Allah continue to bless your union . We need more cuties oh URL584	PRON AUX ADV ADJ PUNCT NOUN PUNCT AUX PROPN VERB PART VERB PRON NOUN PUNCT PRON VERB ADV NOUN INTJ X
Delhi air will never be safe because of its geographical disadvantage : panel to HC URL1614	PROPN PROPN AUX ADV AUX ADJ ADP ADP PRON SYM NOUN PUNCT VERB ADP VERB X
Bullet with butterfly wings .	VERB ADP PROPN PROPN PUNCT
When BB is perfect 😩😍🙌 @USER1548 URL458	ADV PROPN AUX ADJ NOUN NOUN X
@USER1026 PLEASE EXPLAIN TO ME WHY YOU TELLING ME TO SHUT UP WILL ACTUALLY GET ME TO SHUT UP	PROPN INTJ VERB SCONJ PRON ADV PRON VERB PRON PART NOUN SCONJ AUX NOUN VERB PRON ADP NOUN ADP
RT @USER1549 : " wyd this weekend ? " URL871	X X PUNCT PUNCT VERB DET NOUN PUNCT PUNCT SYM
Thankful for another 24	VERB ADP DET NUM
@USER1833 Imma stay at your pad	PROPN VERB VERB ADP PRON NOUN
um can one of my friends pick me up so we can go riding around & talking ?	INTJ AUX NUM ADP PRON NOUN VERB PRON ADV ADV PRON AUX VERB VERB ADJ CCONJ VERB PUNCT
@USER881 I suspect @USER786 's involvement now :/	PROPN PRON VERB NOUN PART ADJ ADV SYM
RT @USER1280 : This is your chance to ask question to LizQuen using ASK TatakLizQuen DolceAmore GrandFansDate #VoteEnriqueFPP #KCA URL0 …	X X PUNCT PRON AUX PRON NOUN PART VERB NOUN ADP PROPN VERB PROPN PROPN PROPN PROPN X X X PUNCT
RT @USER1262 : Your child reading before kindergarten ! This guide can make it happen #kindergarten #ASMSG URL459	X X PUNCT PRON NOUN VERB ADP NOUN PUNCT PRON NOUN AUX VERB PRON VERB PROPN NOUN NOUN
RT @USER1805 : Check out my article about Darren Espanto : URL1153 @USER1025 URL277	X X PUNCT VERB ADP PRON NOUN ADP PROPN X PUNCT PROPN NOUN X
RT @USER1241 : When Taeyeon went on the lift during " U R " and confetti fell , Yoona 's jaw dropped and she took a video of it . URL224 …	X X PUNCT ADV VERB VERB ADP DET NOUN ADP PUNCT PRON X PUNCT CCONJ ADJ VERB PUNCT PROPN PART ADJ NOUN CCONJ PRON VERB DET NOUN ADP PRON PUNCT X PUNCT
Excellent condition 1 BR in an Elevator building ( Gramercy ) $ 3825 1 bd URL478 URL575 #roommate	PROPN PROPN NUM NOUN ADP DET NOUN PROPN PUNCT PROPN PUNCT SYM PROPN NUM PROPN PROPN X X
URL988 Hey ! Check URL1640 for latest cs:go giveaways , free and no sign up needed ;)	PROPN INTJ PUNCT VERB VERB ADP ADJ PROPN NOUN PUNCT ADJ CCONJ DET NOUN ADP VERB SYM
RT @USER25 : Laurmani in red appreciation tweet #VeranoMTV2016 Fifth Harmony URL585	X X PUNCT VERB ADP ADJ NOUN NOUN X PROPN PROPN X
@USER2400 you thought	VERB PRON VERB
RT @USER1702 : hate is never the answer .	X X PUNCT VERB AUX ADV DET NOUN PUNCT
RT @USER1320 : VIDEO : Russian jets violently disrupt Free Syrian Army ceremony in western #Daraa URL402 URL1544 …	X X PUNCT X PUNCT PROPN PROPN PROPN PROPN ADJ NOUN NOUN NOUN ADP ADJ PROPN PROPN X PUNCT
RT @USER2545 : When you go through deep waters , I will be with you . Isaiah 43:2	X X PUNCT ADV PRON VERB ADP ADJ NOUN PUNCT PRON AUX AUX ADP PRON PUNCT X SYM
How many of you really knows that today is my birthday 😍😍 - No I know URL1611	ADV ADJ ADP PRON ADV VERB SCONJ NOUN AUX PRON NOUN NOUN PUNCT SCONJ PRON VERB SYM
#CD #Music On the 6 , #JenniferLopez , New URL840 #Deal #Bargain	PROPN VERB ADP DET NUM PUNCT PROPN PUNCT ADJ NOUN NOUN X
RT @USER1261 : @USER2115 so was I . Especially because he is literally in the room right next to me and I could hear him laughing whi …	X X PUNCT PROPN ADV AUX PRON PUNCT VERB SCONJ PRON AUX ADV ADP DET NOUN ADV ADJ ADP PRON CCONJ PRON AUX VERB PRON NOUN NOUN PUNCT
" He , once again , ripped strands of his hair out and ran to his lair . Preparing for a wonderful barrage . A barrage of excellence . "	PUNCT PRON PUNCT ADV ADV PUNCT VERB VERB ADP PRON NOUN ADV CCONJ VERB ADP PRON NOUN PUNCT VERB ADP DET ADJ NOUN PUNCT DET NOUN ADP PROPN PUNCT PUNCT
@USER1631 so sad I have to miss it 💔 but we will just do a redo when I get back after all you can never have too many 21st birthdays	PROPN ADV ADJ PRON VERB PART VERB PRON SYM CCONJ PRON AUX ADV VERB DET NOUN ADV PRON VERB ADV SCONJ SCONJ PRON AUX ADV VERB ADV ADJ ADJ NOUN
Oh , dear . It 's like the dills who accuse Julan Burnside of making money out of #refugees , do n't bother 2 read . URL1425	INTJ PUNCT ADJ PUNCT PRON AUX VERB DET NOUN PRON VERB PROPN NOUN SCONJ VERB NOUN ADP ADP PROPN PUNCT AUX PART ADJ NUM NOUN PUNCT X
2 people followed me // automatically checked by URL1009	NUM NOUN VERB PRON SYM ADV VERB ADP PROPN
@USER2161 but she been a little distant lately URL1184	PROPN CCONJ PRON AUX DET ADJ NOUN ADV SYM
@USER840 😭 I 'll be your buddy	PROPN SYM PRON AUX AUX PRON NOUN
The Dildo Selfie Stick Exists And We Do n't Know How to Fe ... URL505 URL846	DET ADJ NOUN PROPN PROPN CCONJ PRON AUX PART VERB ADV ADP PROPN PUNCT X X
Be you , and be OK with it . It 's the only way you can be truly happy . Be true to yourself . URL718	AUX PRON PUNCT CCONJ AUX ADJ ADP PRON PUNCT PRON AUX DET ADJ NOUN PRON AUX AUX ADV ADJ PUNCT AUX ADJ ADP PRON PUNCT X
RT @USER1879 : Need extra cash for July 4 weekend ?? Come an flip your cash with me starting at $ 150 , Dm me for more info URL224 …	X X PUNCT VERB ADJ NOUN ADP PROPN ADP NOUN PUNCT VERB DET ADJ PRON NOUN ADP PRON VERB ADP SYM PROPN PUNCT VERB PRON ADP ADJ NOUN X PUNCT
@USER1112 : PM @USER351 struggles to secure EU Deal . See his policy record and latest activity here URL670	PROPN PUNCT NOUN PROPN NOUN ADP PROPN PROPN PROPN PUNCT VERB PRON NOUN NOUN CCONJ ADJ NOUN ADV SYM
o i found one with cloud	INTJ PRON VERB NUM ADP NOUN
RT @USER1464 : Beautiful Chandelier made of Spoons . URL615	X X PUNCT ADJ NOUN VERB ADP PROPN PUNCT X
RT @USER752 : you want it to stop ? how about you just now hear me out for a second how about how about you JUST GIT FUCKING GUD URL221 …	X X PUNCT PRON VERB PRON PART VERB PUNCT ADV ADP PRON ADV ADV VERB PRON ADP ADP DET ADJ ADV ADP ADV ADP PRON ADV PROPN ADV X X PUNCT
RT @USER1268 : Love this ! " Casa Dos Chicos hilltop villa - Villas for Rent in Nayarit " @USER1579 #Travel URL903	X X PUNCT VERB PRON PUNCT PUNCT PROPN PROPN PROPN PROPN NOUN PUNCT NOUN ADP NOUN ADP PROPN PUNCT PROPN NOUN X
RT @USER324 : Ok thread of Chris ' looks cause he lowkey fashionista and ppl sleeping : #ChrisBrown #ICHOOSEBREEZY #backtosleep #Viewer …	X X PUNCT INTJ NOUN ADP PROPN PUNCT VERB VERB PRON VERB ADJ CCONJ NOUN NOUN PUNCT PROPN PROPN X X PUNCT
RT @USER1232 : Amen Bishop Father God please help da USA n help us 2 remove our pride n haughty spirits before da fall n Jesus ' Name ht …	X X PUNCT PROPN PROPN NOUN PROPN INTJ VERB DET PROPN CCONJ VERB PRON NUM VERB PRON NOUN CCONJ NOUN VERB SCONJ DET NOUN CCONJ PROPN PUNCT NOUN X PUNCT
RT @USER1258 : Janitors might as well quit URL1340	X X PUNCT PROPN AUX ADP ADV VERB SYM
RT @USER2565 : Glencoe Lochan by Alan Howe Photography on Flickr ( cc ) #Scotland #photography #forest URL270	X X PUNCT PROPN NOUN ADP PROPN PROPN NOUN ADP PROPN PUNCT PROPN PUNCT PROPN PROPN NOUN X
RT @USER524 : Grey 's Anatomy season 13 is expected to premiere on September 22 . RT to save a life .	X X PUNCT PROPN PART ADJ NOUN NOUN AUX ADJ PART NOUN ADP PROPN NOUN PUNCT VERB PART VERB DET NOUN PUNCT
@USER1107 @USER2064 see the unnecessary fear by an MD . So cruel . URL731	PROPN PROPN VERB DET NOUN NOUN ADP DET NOUN PUNCT ADV PROPN PUNCT X
@USER1710 Glad to see I was n't the only one to think of that ! " No networks ! "	PROPN ADJ PART VERB PRON AUX PART DET ADJ NOUN PART VERB ADP PRON PUNCT PUNCT DET NOUN PUNCT PUNCT
Really trying to get rid of these lmk if you interested !! URL319	ADV VERB PART VERB ADJ ADP DET NOUN SCONJ PRON ADJ PUNCT X
RT @USER2352 : @USER1947 WHY YOU DO THAT TO ME ? I BEEN WRITING ONE HUNDRED TEN TWEET WITH THE SAME QUESTION AND YOU JUST IGNORE M …	X X PUNCT PROPN ADV PRON AUX PRON ADP PRON PUNCT PRON VERB PROPN PROPN PROPN PROPN VERB ADP DET NOUN NOUN CCONJ PRON ADV ADJ NOUN PUNCT
The latest The Claudio Russo Daily ! URL970 Thanks to @USER365 @USER2218 #brexit #technology	DET ADJ DET NOUN PROPN PROPN PUNCT PROPN NOUN ADP PROPN PROPN NOUN NOUN
RT @USER380 : " The Largest Swimming Pool in the World Found at URL606 URL1043 "	X X PUNCT PUNCT DET NOUN NOUN VERB ADP DET PROPN VERB ADP PROPN PROPN PUNCT
RT @USER860 : Season 6 is coming soon . #TeenWolf URL1569	X X PUNCT NOUN NUM AUX VERB ADV PUNCT PROPN X
RT @USER2082 : I need to see #FindingDory	X X PUNCT PRON VERB PART VERB SYM
RT @USER2533 : Rihanna made this a hit , obviously . " So live ya life , ayeeeeee " 😛 URL800	X X PUNCT PROPN VERB DET DET VERB PUNCT ADV PUNCT PUNCT ADV VERB PRON NOUN PUNCT INTJ PUNCT VERB X
RT @USER260 : The Greatest Boyfriend Ever Proposed At A @USER199 Meet And Greet URL971 via @USER1711 htt …	X X PUNCT DET NOUN NOUN ADV VERB ADP DET NOUN NOUN CCONJ VERB NOUN ADP PROPN X PUNCT
RT @USER1664 : Got ta respect Laremy Tunsil tweeting out how strong his lungs are 10 minutes before he gets drafted URL1101 …	X X PUNCT VERB PART VERB PROPN PROPN VERB ADP ADV ADJ PRON NOUN AUX NUM NOUN SCONJ PRON VERB ADJ NOUN PUNCT
@USER723 act u prob right bc my trip next year is gon na cost like 10 k	PROPN VERB PRON VERB ADV SCONJ PRON NOUN ADJ NOUN AUX VERB PART NOUN ADP NUM NUM
⚡️ “ Michelle Obama brought down the DNC house ” URL864	PROPN PUNCT PROPN PROPN VERB ADP DET PROPN NOUN PUNCT X
RT @USER1692 : @USER1674 I was thinking the same thing	X X PUNCT INTJ PRON AUX VERB DET ADJ NOUN
Amazon Kindle 3 keyboard . D00901 . Never Used Still In Plastic - Bid Now ! Only $ 27.01 URL676 URL555	PROPN PROPN NUM NOUN PUNCT PROPN PUNCT ADV VERB ADV ADP NOUN PUNCT VERB ADV PUNCT ADV SYM PROPN PROPN X
RT @USER1415 : I 'd talk about how ZTD came out or how Sigma 's one can be folded up . [ Sat July 2 3:45 pm - 4:45 pm ] [ Place : 408 AB ] I hope …	X X PUNCT PRON AUX VERB ADP ADV NOUN VERB ADV CCONJ ADV NOUN PART NOUN AUX AUX ADJ ADP PUNCT PUNCT PROPN PROPN NUM PROPN NOUN PUNCT PROPN NOUN PUNCT PUNCT PROPN PUNCT PROPN PROPN PUNCT PRON VERB PUNCT
Book release news , and enter to win a $ 25 Amazon gift card ! URL442 #ya #scifi #mystery	PROPN VERB NOUN PUNCT CCONJ VERB PART VERB DET SYM NUM PROPN X NOUN PUNCT PROPN PROPN NOUN X
Eagles of Death Metal return : ' Much more than a show ' URL732 URL480	PROPN ADP PROPN NOUN NOUN PUNCT PUNCT ADJ ADJ ADP DET NOUN PUNCT SYM X
San Miguel , Telstra talks break down URL667	PROPN PROPN PUNCT PROPN NOUN NOUN ADP SYM
#Jesus is not a part time Lord . Amen	PROPN AUX PART DET NOUN NOUN PROPN PUNCT X
Today is the last day I ask my boyfriend to do any prep work for dinner . Boy do n't know how to season anything	NOUN AUX DET ADJ NOUN PRON VERB PRON NOUN PART VERB DET NOUN NOUN ADP NOUN PUNCT PROPN AUX PART VERB ADV ADP NOUN PRON
RT @USER707 : Take some time today and thank God for sending his Son Jesus so that our sins could be forgiven and we can be free . #goodfr …	X X PUNCT VERB DET NOUN NOUN CCONJ VERB PROPN ADP PROPN PRON NOUN PROPN ADV SCONJ PRON NOUN AUX AUX ADJ CCONJ PRON AUX AUX ADJ PUNCT PROPN PUNCT
RT @USER1786 : Arheologist prof. Diana Gergova shows newly discovered mystical ... #velingrad URL1635	X X PUNCT PROPN NOUN PROPN PROPN NOUN NOUN X NOUN PUNCT X X
RT @USER1596 : SLIM THICK W YO CUTE AH @USER1528 URL579	X X PUNCT PROPN PROPN X PROPN PROPN PROPN NOUN X
RT @USER186 : These Failed Tattoos Are Just Absolutely Hilarious … It Will Make You Cry with Laughter URL328 URL223 …	X X PUNCT DET NOUN NOUN AUX ADV ADJ X PUNCT PRON AUX VERB PRON VERB ADP PROPN PROPN X PUNCT
RT @USER950 : I 'm a failure . Allah is my forgiver . I 'm a sinner . Allah is my savior . I 'm broken . Allah is healer .	X X PUNCT PRON AUX DET NOUN PUNCT PROPN AUX PRON NOUN PUNCT PRON AUX DET NOUN PUNCT PROPN AUX PRON NOUN PUNCT PRON AUX ADJ PUNCT PROPN AUX PROPN PUNCT
Great thanks to @USER2580 for allowing me to announce a great night of fights at the @USER1942 . Hope to be back soon .	ADJ NOUN PART VERB SCONJ VERB PRON PART VERB DET ADJ NOUN ADP VERB ADP DET NOUN PUNCT VERB PART AUX ADV ADV PUNCT
RT @USER262 : #JESUS Said , Before Abraham Was , " I AM ! " In John 's Gospel , Jesus said , " I AM " 7 Different Times . Ch. 6 , 8 , 10 , 11 , 15 URL218 …	X X PUNCT PROPN NOUN PUNCT ADP PROPN NOUN PUNCT PUNCT PRON VERB PUNCT PUNCT ADP PROPN PART PROPN PUNCT PROPN VERB PUNCT PUNCT PRON PROPN PUNCT NUM ADJ PROPN PUNCT PROPN NUM PUNCT NUM PUNCT NUM PUNCT NUM PUNCT NUM X PUNCT
He 'll always come back home cause I 'm his backbone 😏	PRON AUX ADV VERB ADV ADV SCONJ PRON AUX PRON NOUN NOUN
Seven hours of video show changes in accused Tochigi killer 's demeanor URL691	ADJ NOUN ADP NOUN NOUN VERB ADP PROPN PROPN PROPN PART ADJ X
@USER1568 lol where Uu wan na go Pee ? 😂😂	PROPN INTJ ADV PROPN VERB PART VERB PROPN PUNCT SYM
Dealing With Erectile Dysfunction URL892	VERB ADP PROPN PROPN X
@USER755 let 's fuckin go	PROPN VERB PART VERB VERB
@USER1264 " WHERE !? " Quickly looks around for the Pichu . " WHERE IS IT !? "	PROPN PUNCT PROPN PUNCT PUNCT PROPN VERB ADJ ADP DET NOUN PUNCT PUNCT PROPN AUX PRON PUNCT PUNCT
Not looking forward to going back to work tomorrow	PART VERB ADV PART VERB ADV PART VERB NOUN
RT @USER1344 : Ordering Wine at a Restaurant : The Cheat Sheet URL1277 #wine #winelovers #food URL1136	X X PUNCT VERB ADJ ADP DET NOUN PUNCT DET VERB PROPN PROPN PROPN PROPN X X
RT @USER1138 : " You say you want a Revolution ... " Hell yeah !!! #Beatles #FeelTheBern #NYPrimary URL624	X X PUNCT PUNCT PRON VERB PRON VERB DET NOUN PUNCT PUNCT NOUN INTJ PUNCT PROPN PROPN NOUN X
@USER23 break the plans we had before let 's be unpredictable	PROPN VERB DET NOUN PRON VERB SCONJ VERB PART AUX ADJ
RT @USER1360 : she 'll show you the world through her eyes URL741	X X PUNCT PRON AUX VERB PRON DET NOUN ADP PRON NOUN X
The Initial step For Internet marketing Success URL1553	DET NOUN VERB ADP NOUN NOUN NOUN X
RT @USER692 : We can live with the confidence that all of our sins have been washed away . That ’s the power of the blood .	X X PUNCT PRON AUX VERB ADP DET NOUN PRON DET ADP PRON NOUN AUX AUX VERB ADV PUNCT PRON AUX DET NOUN ADP DET NOUN PUNCT
Getting ready ... @ Pasco Ephesus Seventh - day Adventist Church URL823	VERB ADJ PUNCT ADP PROPN PROPN PROPN PUNCT NOUN PROPN NOUN X
RT @USER1823 : rebecca mader is so hot .	X X PUNCT PROPN NOUN AUX ADV ADJ PUNCT
RT @USER466 : How modern day learning is evolving thanks to new tech : URL362 #edtech #onlinelearning #elearning URL220 …	X X PUNCT ADV ADJ NOUN NOUN AUX ADJ NOUN ADP ADJ NOUN PUNCT PROPN PROPN X X X PUNCT
RT @USER2367 : If I do n't fwy and your bringing up my name bitch you are BOTHERED and ima keep it real 😂😂💯	X X PUNCT SCONJ PRON AUX PART VERB CCONJ PRON VERB ADP PRON NOUN NOUN PRON AUX ADJ CCONJ VERB VERB PRON ADJ NOUN
The Fight Between Bernie Sanders And Hillary Clinton Is Officially Super Ugly . Very good read . URL1141	DET NOUN NOUN PROPN NOUN CCONJ PROPN PROPN AUX PROPN PROPN ADJ PUNCT ADV ADJ NOUN PUNCT SYM
No emergency budget , no activating article 50 , no plan - if this was #Labour in govt #Murdoch & the rest would be fomenting a #coup	DET NOUN NOUN PUNCT DET NOUN NOUN NUM PUNCT DET NOUN PUNCT SCONJ PRON AUX ADJ ADP PROPN NOUN CCONJ DET NOUN AUX AUX ADJ DET NOUN
RT @USER1238 : Showing your appreciation of sunshine by sitting outside , tilting your head back , closing your eyes and pretending to be …	X X PUNCT VERB PRON NOUN ADP NOUN SCONJ VERB ADJ PUNCT VERB PRON NOUN ADV PUNCT VERB PRON NOUN CCONJ VERB PART AUX PUNCT
God why these kind of people are still exist . They annoyed me so much . I swear . 🙃✋🏼🙂	PROPN ADV DET NOUN ADP NOUN AUX ADV VERB PUNCT PRON VERB PRON ADV ADV PUNCT PRON VERB PUNCT SYM
#SouthBelfast : traffic busy Saintfield Road from Rosetta towards Annadale Avenue / Forestside countrybound	PROPN PUNCT NOUN ADJ NOUN NOUN ADP PROPN PROPN PROPN NOUN PUNCT X X
Ecigs are the febreze for leesville bathrooms 🙄	PROPN AUX DET NOUN ADP PROPN PROPN SYM
RT @USER449 : Any liberal who thinks AR stands for assault rifle and not Armalite , should probably STFU about guns #filibuster	X X PUNCT DET NOUN PRON VERB ADJ NOUN ADP PROPN NOUN CCONJ PART NOUN PUNCT AUX ADV ADJ ADP NOUN NOUN
@USER114 no but really bo1 tournaments would get so many teams it would be so much fun	VERB DET CCONJ ADV VERB PROPN AUX VERB ADV ADJ NOUN PRON AUX AUX ADV ADJ NOUN
Join the Speedway team ! See our latest #CustomerService #job opening here : URL1194 #Greendale , WI #Hiring #CareerArc	VERB DET ADJ NOUN PUNCT VERB PRON ADJ ADJ NOUN NOUN ADV PUNCT PROPN NOUN PUNCT PROPN NOUN X
blessed URL488	PRON NOUN
RT @USER2656 : A silly dragonhardt comic before bed . #overwatch URL878	X X PUNCT DET NOUN NOUN VERB ADP NOUN PUNCT X X
@USER591 @USER1682 ima be rude but not enough fingies to operate it	PROPN PROPN VERB AUX ADJ CCONJ PART ADJ NOUN PART VERB PRON
RT @USER2468 : Other hairstylist : EXO is doing so well on the charts ! Me : yeah , so happy for them O.H : is EXO famous outside of Korea ? Me : ye …	X X PUNCT PROPN NOUN PUNCT PROPN AUX VERB ADV ADV ADP DET NOUN PUNCT PRON PUNCT INTJ PUNCT ADV ADJ ADP PRON NOUN PUNCT AUX ADJ NOUN ADJ ADP PROPN PUNCT PRON PUNCT PRON PUNCT
Some terrific #Leadership lessons from a proven #leader . URL323	DET NOUN NOUN NOUN ADP DET NOUN NOUN PUNCT X
@USER1681 I promise I will never unfollow you !! ❤️😍	PROPN PRON VERB PRON AUX ADV VERB PRON PUNCT X
RT @USER733 : My KC Scout Traffic Alert Cleared : Roadwork on I-470 WB ( East / West ) PAST DOUGLAS ST Message #8252-14783	X X PUNCT PRON ADJ NOUN NOUN SYM NOUN PUNCT VERB ADP PROPN PROPN PUNCT PROPN PUNCT PROPN PUNCT PROPN PROPN PROPN X X
i be soo bored at home 🙄 i need to get that application asap 😬💯	PRON AUX ADJ ADJ ADP NOUN SYM PRON VERB PART VERB PRON NOUN X X
@USER1878 @USER344 you really deserve it	PROPN VERB PRON ADV VERB PRON
@USER1455 So you want my number .... That 's romantic AF !!! hahahha .... You should be polite AF when asking things like that !!! hahahha	VERB ADV PRON VERB PRON NOUN PUNCT PRON AUX ADJ PROPN PUNCT PROPN PUNCT PRON AUX AUX ADJ ADJ ADV VERB NOUN ADP PRON PUNCT X
@USER193 14 exactly	PROPN NUM ADV
I 'm waiting for it URL514	PRON AUX VERB ADP PRON VERB
@USER1567 this is the funniest thing but the shirt gave me good luck so i dunno if ure gon na get that back buddy	VERB PRON AUX DET ADJ NOUN CCONJ DET NOUN VERB PRON ADJ NOUN ADV PRON VERB SCONJ PROPN VERB PART VERB PRON ADV SYM
RT @USER806 : This Dog 's Face Was Eaten By Maggots , See The Transformation Now URL1158	X X PUNCT PRON NOUN PART NOUN NOUN NOUN ADP NOUN PUNCT VERB DET NOUN ADV SYM
@USER1420 was n't sure if you posted about this , the Frisco Roughriders are wearing gaming themed unis on July 8th . URL1214	PROPN AUX PART ADJ SCONJ PRON VERB ADP PRON PUNCT DET NOUN NOUN AUX VERB PROPN PROPN NOUN ADP PROPN PROPN PUNCT X
RT @USER2363 : 🐺 LITTLE TEETH RETURNS 3/4 🐹 written by @USER1900 art by me ! ty @USER551 @USER2459 URL944 URL219 …	X X PUNCT PROPN PROPN PROPN NOUN PROPN NOUN VERB ADP PROPN NOUN ADP PRON PUNCT PROPN PROPN PROPN X X PUNCT
@USER803 " If it 's with you then I do n't mind - "	PROPN PUNCT SCONJ PRON AUX ADP PRON ADV PRON AUX PART ADJ PUNCT PUNCT
Try this Easy Chicken Cordon Bleu #recipe using @USER1049 . #PerdueCrew #promotion - URL647 URL249	VERB DET ADJ NOUN NOUN X X VERB PROPN PUNCT PROPN NOUN PUNCT PROPN NOUN
RT @USER59 : Aisle marking tape Archives | URL1187	X X PUNCT PROPN ADJ NOUN NOUN SYM X
RT @USER282 : Remember when you lay your head down at night that life is precious . And if you 're blessed enough to wake up again remind …	X X PUNCT PROPN ADV PRON VERB PRON NOUN ADV ADP NOUN DET NOUN AUX PROPN PUNCT CCONJ SCONJ PRON AUX VERB ADJ PART VERB ADV ADV VERB PUNCT
that " what 'd I do ? look at her ! " by Stecklein , lol	PRON PUNCT PRON AUX PRON VERB PUNCT VERB ADP PRON PUNCT PUNCT ADP PROPN PUNCT INTJ
RT @USER930 : I started something , I forced you into a zone and you were clearly never meant to go .	X X PUNCT PRON VERB PRON PUNCT PRON VERB PRON ADP DET NOUN CCONJ PRON AUX VERB ADV VERB PART VERB PUNCT
RT @USER1929 : Philosophy - Cambridge University | Psychology & Social ... URL1164 #psychologysocialscience	X X PUNCT PROPN PUNCT PROPN PROPN SYM PROPN CCONJ ADJ PUNCT X NOUN
RT @USER18 : Will D #French #Senate demand FM #Zarif 2end persecution of Christians in #Iran ? #directsenat #no2rouhani #FreeIran URL0 …	X X PUNCT AUX PROPN PROPN PROPN VERB NOUN PROPN NOUN NOUN ADP NOUN ADP PROPN PUNCT PROPN PROPN X X PUNCT
Going to Dj Friday 's parties is just girls excuse to dress up & look cute , do n't even enjoy them anymore	VERB ADP PROPN PROPN PART PROPN AUX ADV NOUN NOUN PART VERB ADP CCONJ VERB ADJ PUNCT AUX PART ADV VERB PRON ADV
RT @USER764 : Does it count as drinking alone if you 're watching the series finale of Buffy ( again ) , you 're folding laundry and your cat is …	X X PUNCT AUX PRON VERB SCONJ PROPN ADV SCONJ PRON AUX VERB DET NOUN NOUN ADP PROPN PUNCT ADV PUNCT PUNCT PRON AUX VERB ADJ CCONJ PRON NOUN AUX PUNCT
I miss the feeling of you missing me	PRON VERB DET NOUN ADP PRON VERB PRON
RT @USER1998 : joshua almost cried so vernon rubbed his back to calm him down omg i find this so so cute URL1072	X X PUNCT PROPN ADV NOUN ADV VERB VERB PRON NOUN PART VERB PRON ADV INTJ PRON VERB PRON ADV ADV ADJ NOUN
go to bet ?? ♡	VERB PART VERB PUNCT SYM
School is so stressful	NOUN AUX ADV ADJ
OneRepublic - Counting Stars URL681 via @USER1490	PROPN PUNCT PROPN NOUN NOUN ADP PROPN
These mfs got me fucked up if they think they bouts give me another blood transfusion	DET NOUN VERB PRON VERB ADP SCONJ PRON VERB PRON VERB VERB PRON DET NOUN NOUN
@USER1449 He knows the game as well as anybody . That 's always been true .	VERB PRON VERB DET NOUN SCONJ ADV ADP PROPN PUNCT PRON AUX ADV AUX ADJ PUNCT
😂 shame he 's a professional wankster URL506	SYM NOUN PRON AUX DET ADJ NOUN SYM
really cool ! URL1011	ADV ADJ PUNCT X
The best is the enemy of good . - Voltaire #quote #winwithjohn	DET ADJ AUX DET NOUN ADP ADJ PUNCT PUNCT PROPN PROPN X
RT @USER891 : @USER2114 well , I happen to be a pro PJ , did n't you know ? I learned 4 songs , more or less . I know , pretty impressive .	X X PUNCT PROPN INTJ PUNCT PRON VERB PART AUX DET ADJ NOUN PUNCT AUX PART PRON VERB PUNCT PRON VERB NUM NOUN PUNCT ADV CCONJ ADV PUNCT PRON VERB PUNCT ADV PROPN PUNCT
RT @USER1158 : Sidney Crosby joins Joe Sakic as only players in history with Olympic Gold World Jr. Gold World Champ Stanley Cup Hart Troph …	X X PUNCT PROPN PROPN PROPN NOUN NOUN ADP ADJ NOUN ADP NOUN ADP PROPN PROPN PROPN PROPN PROPN PROPN PROPN PROPN PROPN PROPN X PUNCT
RT @USER2466 : Quick subs of SNSD cut on today 's Slam Dunk episode ^^ [ ENG SUB ] SNSD CUT - KBS SISTER 'S SLAM DUNK EP7 URL452 …	X X PUNCT VERB NOUN ADP PROPN VERB ADP NOUN PART ADJ PROPN NOUN SYM PUNCT PROPN PROPN PUNCT PROPN PROPN PUNCT PROPN NOUN PART PROPN PROPN PROPN NOUN PUNCT
RT @USER64 : I hate when ppl says " nak tanya ni " but suddenly " em tade pape la " . Lol I 'm freaking curious abt what they want to ask me .	X X PUNCT PRON VERB ADV NOUN VERB PUNCT PROPN PROPN NOUN PUNCT CCONJ NOUN PUNCT PRON PROPN PROPN NOUN PUNCT PUNCT INTJ PRON AUX ADJ NOUN SCONJ PRON PRON VERB PART VERB PRON PUNCT
Two cars hit and we are n't even drunk yet 😂 @USER1658 @USER1394 .	NUM NOUN VERB CCONJ PRON AUX PART ADV ADJ PROPN SYM PROPN PROPN PUNCT
Pablo Sandoval religiously followed the El Guapo diet and exercise plan during the offseason .	PROPN PROPN NOUN VERB DET PROPN PROPN NOUN CCONJ NOUN NOUN ADP DET NOUN PUNCT
RT @USER453 : Childhood Fantasy Destroyed By The Sinister Origins Of These 15 Disney Movies ! URL683 URL1272 …	X X PUNCT PROPN PROPN NOUN ADP DET NOUN NOUN ADP DET NUM PROPN PROPN PUNCT PROPN NOUN PUNCT
RT @USER2012 : How is he so effortlessly beautiful ? These are candid ? He is so soft ? URL959	X X PUNCT ADV AUX PRON ADV ADJ ADJ PUNCT DET AUX NOUN PUNCT PRON AUX ADV ADJ PUNCT SYM
RT @USER290 : Printable Zentangle Colouring Page Seahorse by thecrayonkitchen URL1349 #etsymntt #ESkids #craftbuzz #ep …	X X PUNCT PROPN PROPN PROPN NOUN NOUN ADP PROPN PROPN PROPN PROPN X X PUNCT
Congratulations to @USER1154 for winning #SJA #MedicalFirstResponders #Ontario #Championship . #LdnOnt URL1071	NOUN PART VERB SCONJ VERB PROPN PROPN PROPN NOUN PUNCT X X
Oil and Gas ETFs Update . Select Oil and Gas ETFs at URL1282 or visit URL413	NOUN CCONJ PROPN PROPN NOUN PUNCT PROPN NOUN CCONJ NOUN NOUN ADP PROPN CCONJ NOUN NOUN
RT @USER2449 : Limited Pre-Order : Kim Jae Joong NO.X Hologram Seoul Concert Official Goods worldwide shipping more details pls DM >> ht …	X X PUNCT PROPN NOUN PUNCT PROPN PROPN PROPN PROPN PROPN PROPN NOUN ADJ NOUN ADV ADJ ADJ NOUN INTJ NOUN PUNCT X PUNCT
I Ai n't had sex in while had dream lil vagina 's was chasing me	PRON AUX PART VERB NOUN ADP SCONJ VERB NOUN PROPN NOUN AUX AUX VERB PRON
RT @USER2295 : Church is designed to be a community of friends , where people are not judged , but loved , accepted and welcomed home .	X X PUNCT PROPN AUX ADJ PART AUX DET NOUN ADP NOUN PUNCT ADV NOUN AUX PART VERB PUNCT CCONJ ADJ PUNCT VERB CCONJ VERB NOUN PUNCT
RT @USER1206 : The * ALL NEW * URL233 will be available to all customers at 10:45 pm PST 😅🙌🏽 ! Shop with us TONIGHT 🔥 ht …	X X PUNCT DET PUNCT DET ADJ PUNCT PROPN AUX AUX ADJ ADP DET NOUN ADP PROPN NOUN PROPN NOUN PUNCT VERB ADP PRON PROPN X X PUNCT
Most of supercells music makes me emotional	ADJ ADP PROPN NOUN VERB PRON SYM
RT @USER2293 : Yall never forget this beautiful legendary moment URL1537	X X PUNCT VERB ADV VERB DET ADJ NOUN NOUN X
@USER2639 catching all passes . Might throw some spirals	PROPN VERB DET NOUN PUNCT VERB VERB DET NOUN
RT @USER1533 : Hell yeah ... Same URL1398	X X PUNCT NOUN INTJ PUNCT ADJ NOUN
RT @USER1288 : " Life After Winning The Power Ball " URL1232	X X PUNCT PUNCT NOUN SCONJ VERB DET NOUN NOUN PUNCT SYM
RT @USER823 : The face @USER1569 makes when he rolls a gutter ball 😂🎳 URL1245	X X PUNCT DET NOUN PROPN VERB ADV PRON VERB DET NOUN NOUN NOUN X
RT @USER2156 : Only a few days left ... :) @USER1793 @USER1726 Photo vs Drawing : I try to work precise :) URL489	X X PUNCT ADV DET ADJ NOUN ADJ PUNCT SYM PROPN PROPN NOUN ADP NOUN PUNCT PRON VERB ADP VERB ADJ SYM X
RT @USER1283 : { Preview } 160404 Qianxi @ OPPO R9 CF #Shooting Cr. as tagged URL710	X X PUNCT PROPN PROPN PROPN NOUN NOUN ADP PROPN PROPN PROPN PROPN NOUN ADP NOUN X
RT @USER1372 : Follow & retweet for the love of #prettyporn~ So close to reaching 6 k followers ! URL784	X X PUNCT VERB CCONJ VERB ADP DET NOUN ADP PROPN ADV ADJ ADP PROPN NUM NUM NOUN PUNCT X
OMG I have hope :')	INTJ PRON VERB VERB SYM
My Twitter is worth $ 24,120.00 today . Find Out Your Vanity Twitter Value Free - Click Here ==> URL342 #freefollowers	PRON PROPN AUX ADJ SYM PROPN NOUN PUNCT VERB ADP PRON PROPN PROPN PROPN ADJ PUNCT PROPN ADV VERB X X
" Storm Surf " Tee inspires us all that no matter what the conditions , being in the water is where … URL1230	PUNCT PROPN PROPN PUNCT PROPN VERB PRON DET SCONJ PRON VERB PRON DET NOUN PUNCT AUX ADP DET NOUN AUX ADV PUNCT X
@USER429 Hey Michelle what 's going on ? #StateOfWomen	PROPN INTJ VERB PRON AUX VERB ADP PUNCT X
RT @USER518 : So proud of how hard @USER770 have worked to keep #hellomynameis alive in the organisation ... URL1088	X X PUNCT ADV ADJ ADP ADV ADJ NOUN VERB NOUN PART VERB PROPN ADJ ADP DET NOUN PUNCT X
RT @USER17 : Just because I 'm on Twitter does n't mean I 'm taking texts right now .	X X PUNCT ADV SCONJ PRON AUX ADP PROPN AUX PART VERB PRON AUX VERB ADJ ADV ADV PUNCT
RT @USER1913 : you really need both type of friends URL1060	X X PUNCT PRON ADV VERB DET NOUN ADP NOUN X
RT @USER1735 : She is art . You do n't have to understand her . She was n't built to validate your opinion . Accept her for the beautiful ambiguit …	X X PUNCT PRON AUX NOUN PUNCT PRON AUX PART VERB PART VERB PRON PUNCT PRON AUX PART VERB PART VERB PRON NOUN PUNCT VERB PRON ADP DET ADJ NOUN PUNCT
@USER1729 @USER673 serious question : what 's the deal with the turtle comments ?	PROPN PROPN ADJ NOUN PUNCT PRON AUX DET NOUN ADP DET NOUN NOUN PUNCT
@USER901 @USER1093 Lmao welp . We know he 's either a virgin or he sucks in bed	PROPN PROPN INTJ PROPN PUNCT PRON VERB PRON AUX SCONJ DET NOUN CCONJ PRON VERB ADP NOUN
* CAUTION * if you 've received snaps like these from @USER2446 , you 're not special , you have been mass snapped URL1077	PUNCT PROPN PUNCT SCONJ PRON AUX VERB VERB ADP DET ADP NOUN PUNCT PRON AUX PART ADJ PUNCT PRON AUX AUX ADJ NOUN NOUN
@USER2378 trump i do nt like the sound of that	PROPN PROPN PRON AUX PART VERB DET NOUN ADP PRON
RT @USER463 : Close Enough ! URL660	X X PUNCT PROPN ADJ PUNCT X
How much Faith does the Pope have ?	ADV ADV NOUN AUX DET NOUN VERB PUNCT
RT @USER1062 : “ Whatever you do , never run back to what broke you . ”	X X PUNCT PUNCT VERB PRON VERB PUNCT ADV VERB ADV ADP PRON VERB PRON PUNCT PUNCT
Probably the duff	ADP DET NOUN
As soon as I did lightning stuck really dang close	SCONJ ADV SCONJ PRON AUX PROPN VERB ADV NOUN ADJ
@USER2131 ( if my mom lets but she probably will though lmao )	PROPN PUNCT SCONJ PRON NOUN VERB CCONJ PRON ADV AUX ADV INTJ PUNCT
either 1 bc black af or 4 bc gay and hot af URL876	ADV NUM PART ADJ NOUN CCONJ NUM SCONJ ADJ CCONJ ADJ NOUN SYM
THE HERSHEY 'S WORLD WILL BE THE DEATH OF ME	DET NOUN PART NOUN AUX VERB DET NOUN ADP PRON
RT @USER748 : Ca n't stop a nigga when you know he on a mission	X X PUNCT AUX PART VERB DET NOUN ADV PRON VERB PRON ADP DET NOUN
RT @USER635 : can u name them ? #ALDUBGetThemLolaTini URL1097	X X PUNCT AUX PRON VERB PRON PUNCT X SYM
RT @USER1282 : Lots of hate towards K-Pop fans right now . If you want your favs to win then vote hard like them . No need for racist comme …	X X PUNCT VERB ADP VERB PROPN PROPN NOUN ADV ADV PUNCT SCONJ PRON VERB PRON NOUN PART VERB ADV NOUN ADJ ADP PRON PUNCT DET NOUN ADP ADJ NOUN PUNCT
RT @USER1928 : @USER530 #FindGodWithin Happy Propose day Guru ji URL1078	X X PUNCT X PROPN ADJ NOUN NOUN PROPN X X
RT @USER2232 : I know I will never be everyones 's cup of tea but I would like to be someone 's custom made drink .	X X PUNCT PRON VERB PRON AUX ADV AUX ADJ PART NOUN ADP NOUN CCONJ PRON AUX VERB PART AUX PRON PART ADJ VERB NOUN PUNCT
I wan na hear you myself . Forget the TL . URL466	PRON VERB PART VERB PRON PRON PUNCT VERB DET NOUN PUNCT X
RT @USER289 : Never forget . The whole of a religious group should n't be judged by the extreme actions of a few within their ranks . URL219 …	X X PUNCT ADV VERB PUNCT DET ADJ ADP DET NOUN NOUN AUX PART AUX VERB ADP DET ADJ NOUN ADP DET NOUN ADP PRON NOUN PUNCT X PUNCT
RT @USER1781 : Me : * is dead * Louis and Harry : plays rock paper scissors , Harry touches Louis ' hand Me : URL721	X X PUNCT PRON PUNCT PUNCT AUX ADJ PUNCT PROPN CCONJ PROPN PUNCT VERB PROPN NOUN NOUN PUNCT PROPN PROPN PROPN PUNCT NOUN PRON PUNCT X
@USER2068 I think your all just mad now because I spilled the truth on it .. Devan always seems to get left overs with who he 's with 🌚	PROPN PRON VERB PRON ADV ADV ADJ ADV SCONJ PRON VERB DET NOUN ADP PRON PUNCT VERB ADV VERB PART VERB ADJ NOUN ADP PRON PRON AUX ADP SYM
RT @USER1085 : I cant believe yall never been to this part of Omaha 🤔 URL1163	X X PUNCT PRON AUX VERB PRON ADV AUX ADP DET NOUN ADP PROPN SYM X
@USER1741 Ok but Hannigan is a JAG . Leon has some energy , decent arm and surprising bat .	PROPN INTJ CCONJ NOUN AUX DET NOUN PUNCT PROPN VERB DET NOUN PUNCT VERB NOUN CCONJ ADJ NOUN PUNCT
RT @USER2593 : mi abuela Maria so annoying smh URL1069	X X PUNCT NOUN PROPN PROPN ADV ADJ INTJ SYM
RT @USER1858 : It 's all starting !!!!! @USER1076 @USER46 @USER1029 #blessed first table Read ! URL1557	X X PUNCT PRON AUX DET VERB PUNCT PROPN PROPN PROPN NOUN ADJ NOUN VERB PUNCT X
DDO woman living with mould / collapsed ceiling after flooding Feb 15 in vacant unit above . Condo assoc. denying resp. URL902	PROPN NOUN NOUN ADP PROPN PUNCT PROPN NOUN ADP PROPN NOUN NUM ADP PROPN PROPN ADP PUNCT PROPN PROPN PROPN NOUN X
@USER519 @USER1903 This deserves many favorites .	PROPN VERB PRON VERB ADJ NOUN PUNCT
RT @USER1546 : If this is n't me then what is URL1414	X X PUNCT SCONJ PRON AUX PART PRON ADV PRON AUX ADJ
I will do what you want on my cam . URL411 #threesome #bootylicious #sexdating #pussyfuck URL616	PRON AUX VERB PRON PRON VERB ADP PRON NOUN PUNCT PROPN PROPN PROPN PROPN X X
When 's it going to be my turn to have a cute relationship with someone who actually cares for me ://	ADV AUX PRON VERB PART AUX PRON VERB PART VERB DET ADJ NOUN ADP PRON PRON ADV VERB ADP PRON SYM
I 'm ALIVE ! Fucking cold you can go to hell ...	PRON AUX ADJ PUNCT VERB NOUN PRON AUX VERB ADP NOUN PUNCT
RT @USER433 : Most laugh tracks for TV were recorded in the 1950s , which means many of the people you hear laughing are dead .	X X PUNCT ADJ PROPN NOUN ADP NOUN AUX NOUN ADP DET NOUN PUNCT PRON VERB ADJ ADP DET NOUN PRON VERB NOUN AUX ADJ PUNCT
RT @USER2233 : Gun violence causes 30,000 deaths a year , but some refuse to call it a legitimate public health issue #yourmiccheck URL612 …	X X PUNCT NOUN NOUN PROPN VERB VERB DET NOUN PUNCT CCONJ DET NOUN PART VERB PRON DET ADJ NOUN NOUN NOUN X X PUNCT
Ii Guess Ii Wo n't Be Getting What Ii Want Tonight ..	PROPN VERB PROPN NOUN PART AUX VERB PRON NOUN VERB NOUN PUNCT
RT @USER1599 : 1D stans starter pack URL306	X X PUNCT PROPN PROPN NOUN NOUN X
RT @USER1001 : 6 ) WITH YOU WAS MY FUCKING JAM URL1361	X X PUNCT NUM PUNCT SCONJ PRON AUX PRON ADV NOUN X
RT @USER1153 : do you ever just look at yourself in snapchat front camera and just stare and that s it URL1103	X X PUNCT AUX PRON ADV ADV VERB ADP PRON ADP PROPN NOUN NOUN CCONJ ADV VERB CCONJ PRON AUX PRON VERB
RT @USER654 : Former Bush Treas Sec ( & China hand ) Hank Paulson sets example that should shame the Vichy Republicans URL1146 …	X X PUNCT ADJ PROPN PROPN PROPN PUNCT CCONJ PROPN NOUN PUNCT PROPN PROPN PROPN VERB PRON AUX NOUN DET NOUN X X PUNCT
RT @USER501 : beach party with @USER450 and @USER1886 looks fun af ☀️ 🌴 #AIMHvideo URL457 URL1365	X X PUNCT VERB NOUN ADP PROPN CCONJ PROPN VERB ADJ NOUN PROPN PROPN NOUN X X
RT @USER1391 : Now Northern Ireland and Polish fans are fighting in Nice ! URL1472	X X PUNCT ADV ADJ NOUN CCONJ ADJ NOUN AUX VERB ADP PROPN PUNCT X
RT @USER1131 : Wait omg I had no clue people were WATCHING 👀 URL1225	X X PUNCT VERB INTJ PRON VERB DET NOUN NOUN AUX ADJ NOUN SYM
RT @USER2058 : Hashtag national have an excuse to get drunk off wine day	X X PUNCT PROPN ADJ VERB DET NOUN PART VERB ADJ ADP NOUN NOUN
@USER1311 if I had one of these I would go back to 2008 and never connect with u guys URL629	VERB SCONJ PRON VERB NUM ADP SCONJ PRON AUX VERB ADV PART VERB CCONJ ADV VERB ADP PRON NOUN SYM
@USER1132 Gon na have to buy a Rico Riders t shirt soon ..	PROPN VERB PART VERB PART VERB DET NOUN PROPN X NOUN ADV PUNCT
You know times are hard when even Batman is having a go at you .. URL1336	PRON VERB NOUN AUX ADJ ADV ADV PROPN AUX VERB DET VERB ADP PRON PUNCT X
New day , new tweets , new stats . 1 new unfollower . Via good old URL373	ADJ NOUN PUNCT ADJ NOUN PUNCT ADJ NOUN PUNCT NUM ADJ NOUN PUNCT PROPN ADJ ADJ NOUN
RT @USER2267 : I extend my gratitude to all the members of Delhi study group for selecting me as the patron of the organization . URL224 …	X X PUNCT PRON VERB PRON NOUN ADP DET DET NOUN ADP PROPN PROPN NOUN ADP VERB PRON ADP DET NOUN ADP DET NOUN PUNCT X PUNCT
@USER1812 No , I 'm not . It 's definitely not a rapper .	VERB INTJ PUNCT PRON AUX PART PUNCT PRON AUX ADV PART DET NOUN PUNCT
